Gg, Gg, Gg, Gs^Fp, Re, Rb, Gg, Gg, Gs^Fp, Gs^Fp, Ww^Qhu, Ww^Qhu, Gg, Gg, Gg, Gg, Gg, Ww, Ww, Ww, Gs^Fp, Gs^Fp, Gs^Fp, Gs^Fp, Ss, Ss, Ss, Ss, Ss, Ss, Ss, Gs^Fp, Ss, Ss, Ss, Gs^Fp, Ss, Ss, Ss, Ss, Ss, Ss
Ww^Qhu, Ww^Qhu, Gg, Gg, Re, Gg, Gg, Gs^Fp, Gll^Fp, Gs^Fp, Gs^Fp, Gg, Gg, Gg, Gg, Gg, Gg, Ww, Ww, Ww, Ww, Gs^Fp, Gll^Fp, Gll^Fp, Gll^Fp, Ss, Ss, Ss, Ss, Ss, Ss, Ss, Ss, Ss, Ss, Gs^Fp, Ss, Ss, Ss, Ss, Ss, Ss
Ww^Qhu, Ww^Qhu, Gg, Gg, Re, Gg, Gg, Gs^Fp, Gs^Fp, Gs^Fp, Gs^Fp, Gg, Gg, Gg, Gg^Efm, Gg, Gs^Fp, Gs^Fp, Ww, Ww, Ww, Gs^Fp, Gs^Fp, Gs^Fp, Gs^Fp, Ss, Ss, Ss, Gs, Gs, Gs, Ss, Ss, Gs^Fp, Gs^Qhh, Gs^Fp, Ss, Ss, Gs^Fp, Ss, Ss, Gg
Ww^Qhu, Ww^Qhu, Gg, Gg, Re, Gg, Gg, Re^Vct, Ce, Ce, Ce, Re^Vct, Gg, Gg^Efm, Gg, Gg, Gs^Fp, Gs^Fp, Ww, Ww, Ww, Gs^Fp, Gs^Fp, Gs^Fp, Gs^Fp, Ss, Ss, Gs, Gs, Gs^Efm, Gs, Ss, Ss, Gs^Qhh, Gs^Vd, Chs^Qhu, Chs^Qhh, Chs^Qhu, Gs^Fp, Ss, Ss, Ss
Ww^Qhu, Ww^Qhu, Ww^Qhu, Gg, Re, Gg^Efm, Gg^Efm, Re^Vct, Ce, 3 Ke, Ce, Re^Vct, Gg, Gg, Gg, Gg, Gs^Fp, Gs^Fp, Ww, Ww, Ww, Ww, Gg, Gs^Fp, Gs^Fp, Gs^Fp, Ss, Ss, Hh^Vd, Hh, Gs^Qhhf, Ss, Ss, Ss, Re, Chs^Qhu, 2 Khs, Chs^Qhu, Gs^Qhh, Gs^Fp, Ss, Ss
Ww^Qhu, Gg, Gg, Gg, Re, Gg, Gg, Gg, Gg, Re^Vct, Gg, Re, Gg, Gg, Gg, Gg, Gs^Vh, Gs^Fp, Ww, Ww, Ww, Ww, Ce^Qhh, Gs^Esd, Gs^Fp, Gs^Fp, Ss, Ss, Ss, Gs^Qhhf, Gs^Fp, Gs^Qhhf, Ss^Bw/, Ss^Bw/, Ss, Gs^Qhh, Gs^Vd, Gs^Qhh, Gs^Vd, Gs^Fp, Gs^Fp, Ss
Gg, Gg, Gg, Gg, Gg, Re, Gg^Fp, Gg, Re, Gg, Gg^Fp, Re, Re, Gg^Fp, Gg, Gs^Fp, Re, Gs^Fp, Ww, Ww, Ww^Bw/, Ww^Bw/, Gll^Fp, Gs, Gs^Fp, Gs^Fp, Ss, Ss, Gs^Fp, Gs^Qhhf, Re^Qhhf, Re^Qhhf, Gs^Fp, Ss, Ss, Gs^Fp, Gs^Fp, Gs^Fp, Gs^Fp, Gs^Fp, Gs^Fp, Ss
Gg, Gg, Gg, Gg, Rb^Esd, Re, Re, Re, Gg, Re, Re, Re^Esd, Gg^Efm, Re, Re, Gg, Re, Gg, Ce^Qhh, Ww^Bw/, Ww, Gs^Fp, Gs^Fp, Gs^Fp, Ss, Ss, Ss, Ss, Re, Re^Qhhf, Gs^Qhhf, Gs^Qhhf, Gs^Fp, Ss, Gs, Ss, Ss, Gs^Fp, Gs^Fp, Gs^Fp, Gs^Fp, Ss
Re, Re, Re, Re, Hh, Gg, Gg, Gg, Gg^Efm, Gg, Gg, Gg, Gg, Gg, Gg^Vl, Re, Gg^Fp, Re^Esd, Gg, Ww, Wo, Ww, Gg, Gs^Fp, Ss, Ss, Ss, Ss, Re, Gs^Qhhf, Gs^Fp, Gs^Qhhf, Gs, Gs, Gs, Ss, Ss, Gs^Fp, Gs^Fp, Gs^Fp, Gs^Fp, Gs^Fp
Mm, Mm, Mm, Mm, Hh, Hh, Gg, Gg, Gs^Vh, Gg, Gg, Gg^Fp, Gg, Gg, Gg, Re, Gg, Gg, Gg, Ww, Wo, Ww, Gs^Fp, Gs^Fp, Gs^Fp, Gs^Fp, Ss, Ss, Re, Ww, Ss, Ss, Gs, Gs^Fp, Ss, Ss, Ss, Ww, Ss, Ss, Gs^Fp, Gs^Fp
Mm, Mm, Mm, Mm, Mm, Hh, Hh, Gg, Gg, Gg, Gg, Gg, Gg, Gg, Gg, Re, Gg, Gg, Ss, Ww, Ww, Gs^Fp, Gs^Fp, Ss, Ss, Gs^Fp, Ss, Ss, Ww^Bw|, Ww, Ww, Ss, Ss, Gs^Fp, Gs^Fp, Ss, Ww, Ww, Ww, Ss, Ss, Ss
Mm, Mm, Mm, Mm, Mm, Mm, Hh, Gg, Ss, Gs^Fp, Gg, Gg, Ss, Gg, Ss, Re, Ss, Ss^Vhs, Ss, Ww, Gs^Fp, Gs^Fp, Ss, Ss, Ss, Ss, Ss, Gs^Fp, Ww^Bw|, Ww, Ww, Ww, Gs^Fp, Ww, Ww^Vd, Ww, Ww^Ewf, Wo, Ww, Ww, Gs^Fp, Gs^Fp
Mm, Mm, Mm, Mm, Mm, Mm, Mm, Hh, Ss, Ss, Ss, Gs^Fp, Gs^Fp, Ss, Ss, Ss^Bw|, Gs^Fp, Gs^Fp, Ss, Ss, Gg, Gg, Gs, Gs, Ss^Bw\, Ss, Ss, Gs^Fp, Re, Wo, Wo, Wo, Wo, Wo, Wo, Wo, Wo, Ww, Ww, Ss, Gs^Fp, Gs^Fp
Mm, Mm, Mm, Mm, Mm, Mm, Mm, Hh, Ss^Vhs, Ss, Ss, Ss, Ss, Gs^Fp, Ss, Ss^Bw|, Gs^Fp, Ss, Ss, Ss, Gs, Gs, Gg, Ss, Ss, Gs, Gs, Re, Ww, Wo, Wo, Wo, Wo, Wo, Wo, Wo, Wo, Ww, Ss, Ss, Gs^Fp, Gs^Fp
Mm, Mm, Mm, Mm, Mm, Mm, Mm, Hh, Hh, Ss, Ss, Ss, Ss, Ss, Gs^Fp, Re, Ww^Bw/, Gs, Gs, Ss^Bw/, Gg, Gg, Gg, Gg, Ss, Ss^Bw|, Ss, Ss, Ww, Wo, Wo, Wo, Wo, Wo, Wo, Wo, Wo, Ww, Ss, Ss, Gs^Fp, Gs^Fp
Mm, Mm, Mm, Mm, Mm, Mm, Mm, Mm, Hh, Ss, Ss, Ss, Ss, Ss^Vhs, Re, Re, Ww, Ww, Chs, Ss, Ss, Ss, Ss, Ss, Gg, Re, Ss, Ss, Ww, Wo, Wo, Wo, Wo, Wo, Wo, Wo, Wo, Ww^Ewl, Ww, Ss, Gs^Fp, Ss
Hh, Hh, Mm, Mm, Mm, Mm, Mm, Hh, Hh, Ss, Ss, Ss, Ss^Bw/, Ss^Bw/, Ww, Wo, Wo, Wo, Chs, Khs, Gs^Fp, Ss, Ss, Gg, Hh, Re, Re, Hh^Qhh, Ww, Ww, Ww, Wo, Wo, Wo, Wo, Wo, Wo, Ww, Ww, Ww, Ww^Ewf, Gg
Hh, Hh, Hh, Mm, Mm, Mm, Mm, Mm, Hh, Ss, Cte, Ss^Bw/, Ww, Wo, Wo, Wo, Ww^Ewl, Wo, Wo, Chs, Ss, Ss, Ss, Hh^Vd, Hh, Gg, Gg, Re, Ww, Ww, Ww^Ewl, Ww, Ww, Ww^Ewf, Ww, Wo, Wo, Wo, Wo, Wo, Wo, Ww
Ss, Hh, Hh, Mm, Mm, Mm, Mm, Hh, Hh, Ss, Ww^Bw|, Ww, Ww, Wo, Ww^Ewl, Wo, Wo, Wo, Wo, Wo, Ww, Ss, Ss, Ss, Ss, Ss, Ss, Ww^Bw|, Ss, Gg, Ww, Ww, Ww, Ww, Ww^Ewl, Wo, Wo, Wo, Wo, Ww, Ww, Gg
Ss, Ss, Hh, Hh, Mm, Hh, Hh, Ss, Ss, Gg, Re, Ww, Ww, Wo, Wo, Wo, Wo, Wo, Wo, Wo, Wo, Ww, Ss, Ss, Ss, Ss, Gs^Fp, Re, Gs^Fp, Ss, Ss, Ww, Ww, Ww, Ww, Ww, Ww, Ww, Ww, Ww, Gg, Gg
Ss, Ss, Gg, Hh, Hh, Hh, Gg, Gg, Gg, Gg^Vd, Re, Ww, Ww, Wo, Wo, Ww, Ww, Ww^Ewf, Ww, Ww, Wo^Bw/, Ww^Bw/, Ss, Ss, Ss, Gs^Fp, Ss, Re, Re, Gs^Fp, Re, Ww, Ww, Ww, Ww, Ww, Ww, Ww, Ww, Gg, Gg, Gg
Ss, Ss, Ss, Gg, Gg, Gg, Gg, Cte^Qhh, Re, Re, Ww, Ww^Bw\, Ww^Bw\, Wo, Ww, Ww, Ww, Ww, Ww^Bw/, Ww^Bw/, Ww, Wo, Ww, Ss, Ss, Gs^Fp, Ss, Gs^Fp, Gs^Fp, Re, Gs^Fp, Re, Re, Ww, Ww, Ss, Ss, Ss, Gg, Gg^Efm, Gg, Gg
Gs^Fp, Ss, Ss, Ss, Ss, Ss, Gg, Re, Ww, Ww, Ww^Ewl, Ww, Wo, Ww^Bw\, Gs^Vd, Gs^Fp, Gs^Fp, Ss, Ss, Ww, Ww, Ww, Ww^Ewl, Ww, Ss, Gs^Fp, Gs^Fp, Gs^Fp, Ss, Ss, Ss, Gs^Fp, Re, Ww, Gs^Fp, Ss, Gg, Gg, Gg, Gg^Efm, Re, Gg
Ss, Ss, Ss, Ss, Ss, Ss, Cte^Qhh, Re, Ww, Ww^Ewl, Ww, Ww, Ww, Gs^Fp, Gs^Fp, Sm^Qhh, Cte^Qhh, Cte^Qhh, Cte^Qhh, Ss, Ww, Ww, Ww^Ewl, Ww, Gs^Fp, Gs^Fp, Ss, Ss, Ss, Ss, Ss, Ss, Gs^Fp, Re, Ss^Bw\, Ss, Re, Re, Re, Re, Gg, Re
Ss, Hh, Ss, Ss, Ss, Sm^Qhh, Ss, Ss, Ss, Ww, Ww, Ww, Ww, Gs^Fp, Gs^Fp, Ss^Vd, Cte^Qhh, 1 Kte^Qhh, Cte^Qhh, Ss, Ww^Vd, Ww, Ww, Ww, Ww, Ss, Ss, Ss, Ss, Hh^Qhh, Ss, Ss, Gs^Fp, Ss, Ss, Re, Gg, Gg, Ss, Ss, Ss, Ss
Ss, Ss, Ss, Ss, Ss, Sm^Qhh, Ss, Ss, Ss, Ss, Ss, Ww, Gs^Fp, Gs^Fp, Ss, Ss, Ss^Vd, Cte^Qhh, Ss^Vd, Ss, Ss, Ww, Wo, Ww, Ww, Ss, Ss, Ss, Hh^Qhh, Ss, Ss, Ss, Gs^Fp, Gs^Fp, Ss, Gg, Gg, Ss, Ss, Ss, Gs^Fp, Ss
Ss, Ss, Ss, Ss, Sm^Qhh, Sm^Qhh, Ss, Ss, Gs^Fp, Ss, Ss, Gs^Fp, Ss, Gs^Fp, Ss, Ss, Ss, Ss, Ss, Gs^Fp, Gs^Fp, Ww, Wo, Ww^Ewf, Ww, Ss, Ss, Ss, Ss, Ss, Ss, Ss, Ss, Ss, Gg, Gg, Gg, Ss, Ss, Gs^Fp, Gs^Fp, Ww
Ss, Ss, Ss, Sm^Qhh, Ss, Ss, Ss, Ss, Ss, Ss, Ss, Gs^Fp, Gs^Fp, Ss, Ss, Ss, Ss, Ss, Ss, Ss, Gs^Fp, Ww, Wo, Ww, Ww, Ss, Gg, Ss, Ss, Ss, Ss, Ss, Ss, Ss, Gg, Gg, Gg, Ss, Ss, Gs^Fp, Ww, Ww
Ss, Ss, Sm^Qhh, Sm^Qhh, Ss, Ss, Ss, Ss, Ss, Ss, Ss, Gs^Fp, Gs^Fp, Ss, Ss, Ss, Ss, Ss, Gs^Fp, Gs^Fp, Gs^Fp, Ww, Wo, Ww, Ww, Ss, Gg, Gg, Ss, Ss, Ss, Gs^Fp, Ss, Ss, Gg, Gg, Ss, Ss, Gs^Fp, Gs^Fp, Ww, Ww
Ss, Ss, Sm^Qhh, Ss, Ss, Ss, Ss, Ss, Ss, Ss, Ss, Ss, Ss, Gs^Fp, Gs^Fp, Ss, Ss, Gs^Fp, Gs^Fp, Gs^Fp, Ww, Ww, Ww, Ww, Ww^Ewl, Ww, Ss, Ss, Ss, Ss, Gs^Fp, Ss, Ss, Ss, Gg, Gg, Ss, Gs^Fp, Gs^Fp, Ss, Ww, Wo
Sm^Qhh, Sm^Qhh, Ww, Gs^Fp, Ss, Ss, Ss, Ss, Ss, Ss, Ss, Ss, Ss, Gs^Fp, Ss, Ss, Ss, Ss, Ss, Ss, Gs^Fp, Ww^Ewf, Ww, Ww^Ewl, Ww, Ww, Ss, Gg, Ss, Ss, Ss, Ss, Ss, Ss, Ss, Gg, Ss, Ss, Ss, Gs^Fp, Ww, Ww
Ww, Ww, Wo, Ww, Ww, Ww, Ww, Gs^Fp, Ss, Ss, Ss, Ss, Ss, Ss, Ss, Ss, Ss, Ss, Ss, Ss, Ww, Ww, Ww, Ww, Wo, Ww, Ss, Ss, Ss, Ss, Ss, Ss, Ss, Ss, Ss, Ss, Ss, Ss, Ss, Ss, Ww, Ww
Ww, Ww, Wo, Ww, Ww, Ss, Gs^Fp, Gs^Fp, Ss, Ss, Ss, Gg, Gg, Gg, Gg, Gg, Gg, Gg, Gg, Ss, Ww, Ww, Wo, Wo, Ww, Ww, Ss, Ss, Ss, Ss, Ss, Ss, Gs^Fp, Gs^Fp, Ss, Ss, Ss, Ss, Ss, Ss, Ww, Ww
Ww, Ww, Wo, Ww, Ww, Gs^Fp, Gs^Fp, Ss, Ss, Ss, Ss, Ss, Gg, Gg, Gg, Gg, Gg, Gg, Gg, Ss, Ss, Wo, Wo, Wo, Wo, Ww, Ss, Ss, Ss, Ss, Gs^Fp, Gs^Fp, Gs^Fp, Gs^Fp, Ss, Ss, Ss, Ss, Ss, Ss, Ww, Ww
