Ur, Tb^Tf, Tb^Tf, Uue, Uhe, Tb^Tf, Tb^Tf, Uue, Uue, Tb^Tf, Tb^Tf, Uue, Uue, Uu^Qhh, Uu^Qhh, Uu^Qhh, Uu^Qhh, Uu^Qhh, Uu^Qhh, Uu^Qhh, Uh^Qhh, Xu, Xue, Xue, Uhe, Uue, Qxu^Qhux, Qxu^Qhux, Xu, Rb^Qhh, Uu^Qhh, Uue^Qhh, Xu, Xu, Xu, Xu, Xu, Xu, Xu, Xu, Xu, Xu
Tb^Tf, Ur, 1 Ur, Uue, Uhe, Tb^Tf, Xue, Tb^Tf, Tb, Uue, Tb^Tf, Tb^Tf, Uue, Uue, Uue, Uu^Qhh, Uu^Qhh, Uu^Qhh, Uh^Qhh, Uu^Qhh, Uh^Qhh, Xu, Xue, Xue, Uhe, Uhe, Qxu^Qhux, Qxu^Qhux, Rb^Qhh, Rb^Qhh, Xu, Xu, Xu, Xu, Xu, Xu, Xu, Xu, Xu, Xu, Xu, Xu
Tb^Tf, Uu^Qhh, Ur, Xue, Xue, Xue, Xue, Xue, Xue, Ds, Ds, Tb, Tb^Tf, Uue, Uue, Uue, Xu, Uu^Qhh, Uh^Qhh, Uh^Qhh, Uh^Qhh, Xu, Qxe, Uhe, Rb, Rb, Rb, Qxu^Bh/, Qxu^Qhux, Xu, Uu^Qhh, Uh^Qhh, Xu, Xu, Xu, Xu, Xu, Tb^Tf, Uh^Qhh, Tb^Tf, Xu, Xu
Tb^Tf, Uh^Qhh, Xu, Ur, Xue, Sm, Ww, Ww, Xue, Ww^Ewl, Ds, Sm, Tb^Tf, Uue, Uue, Xue, Xue, Xu, Uh^Qhh, Xu, Xu, Qxe, Qxe, Uhe, Rb, Tb^Tf, Tb^Tf, Tb, Tb, Tb, Tb^Tf, Uh^Qhh, Uh^Qhh, Xu, Xu, Uu^Qhh, Uu^Qhh, Uh^Qhh, Uu^Qhh, Tb, Uu^Qhh, Uu^Qhh
Tb^Tf, Uu^Qhh, Uu^Qhh, Ur, Sm, Sm, Ww^Ewf, Ww^Ii, Ww, Ww, Tb^Tf, Tb^Tf, Tb, Tb^Tf, Xue, Xue, Xue, Xu, Cte, Xu, Xue, Xue, Uue, Uhe, Rb, Tb^Tf, Sm, Sm, Tb^Tf, Uue, Uue, Uh^Qhh, Uh^Qhh, Uu^Qhh, Uu^Qhh, Uu^Qhh, Uu^Qhh, Uh^Qhh, Uue, Uu^Qhh, Tb^Tf, Tb^Tf
Tb^Tf, Ds, Ds, Ur, Ww^Bp\, Ww, Ww, Ww, Ww, Ww, Tb^Tf, Tb, Tb^Tf, Ss, Sm^Qhux, Xue, Xue, Cte, 2 Kte, Cte, Xue, Xue, Uue, Rb, Uue, Tb, Tb, Ss, Tb^Tf, Uue, Xue, Uhe, Uue, Cte, 3 Kte, Uu^Qhh, Uue, Uue, Xue, Uhe, Uue, Xue
Ww, Ww, Ww^Ewf, Ds, Ds, Ww^Bp\, Sm^Bp\, Sm, Sm, Ds, Uue^Qhu, Tb, Tb, Sm^Qhux, Tb^Tf, Tb^Tf, Xue, Xue, Xue, Xue, Xue, Xue, Uue, Rb, Tb^Tf, Tb^Tf, Ss, Tb^Tf, Tb, Uue, Xue, Uhe, Uue, Cte, Cte, Cte, Uhe, Xue, Xue, Uhe, Uhe, Xue
Tb^Tf, Tb, Ds, Ww^Ii, Ww, Sm, Uue, Ur, Ur, Uue^Dr, Uue^Qhu, Tb^Tf, Tb^Tf, Tb^Tf, Tb, Tb, Xue, Xue, Xue, Xue, Xue, Xue, Xue, Rb, Rb, Tb^Tf, Ss, Tb, Uue, Uhe, Uhe, Uhe, Uue, Uue, Tb^Tf, Uhe, Uhe, Xue, Xue, Uhe, Uhe, Xue
Tb^Tf, Tb^Tf, Uu^Qhh, Ds, Ds, Sm, Xue, Xue, Uue, Ur, Ur, Uue^Qhu, Uue^Qhu, Tb^Tf, Ur, Tb^Tf, Ur, Uue^Qhu, Uue^Qhu, Uhe^Qhu, Uhe^Qhu, Xue, Uue^Qhu, Uue^Qhu, Uue^Dr, Rb, Uue, Ss, Ss, Uhe, Xue, Uhe, Uue, Uue, Uue, Uhe, Uue, Xue, Xue, Qxe, Qxe, Qxe
Uh^Qhh, Uu^Qhh, Uu^Qhh, Uu^Qhh, Uue, Uue, Xue, Xue, Xue, Uue, Uue, Ur, Ur, Ur^Dr, Tb, Ur, Tb, Ur, Ur, Uue^Qhu, Uhe^Qhu, Uhe^Qhu, Uue^Qhu, Uue^Qhu, Tb, Rb, Uue, Uue, Tb^Tf, Qxe, Uue, Uue, Uue^Dr, Uue, Uue, Uue, Uue, Xue, Xue, Xue, Xue, Qxe
Uh^Qhh, Uh^Qhh, Uu^Qhh, Uu^Qhh, Uue, Uue, Uue, Xue, Xue, Xue, Xue, Uue, Uue, Uue, Tb^Tf, Sm, Tb, Uhe, Uhe, Ur, Ur, Uue^Qhu, Uue, Tb^Tf, Rb, Rb, Tb^Tf, Tb^Tf, Uue, Qxe, Qxe, Uue, Uhe, Uhe, Uhe, Xue, Xue, Cte, Xue, Xue, Xue, Xue
Xu, Xu, Uu^Qhh, Uue, Uue, Uue, Qxe, Qxe, Qxu, Xu, Xu, Xu, Xu, Xu, Uu^Qhh, Tb^Tf, Tb^Tf, Tb^Tf, Tb^Tf, Uhe, Uhe^Dr, Ur, Uue, Rb, Tb^Tf, Tb, Tb, Uhe, Xue, Qxe, Tb^Tf, Uhe, Uue, Uue, Uue, Xue, Xue, Cte, Xue, Xue, Xue, Xue
Xue, Xue, Uue, Tb, Tb^Tf, Uue, Tb^Tf, Tb^Tf, Xu, Uh^Qhh, Uh^Qhh, Uh^Qhh, Xu, Xu, Uu^Qhh, Uu^Qhh, Tb^Tf, Tb^Tf, Tb, Tb^Tf, Ur, Ur, Rb, Rb, Uue^Qhux, Tb^Tf, Uhe, Uhe, Xue, Xue, Xue, Uue, Uue^Qhux, Uue^Qhux, Uue^Qhux, Xue, Xue, Cte, Xue, Xue, Xue, Xue
Xue, Xue, Uue, Tb^Tf, Tb, Tb^Tf, Tb^Tf, Xu, Xu, Tb, Tb^Tf, Uh^Qhh, Uh^Qhh, Xu, Uu^Qhh, Uu^Qhh, Tb^Tf, Tb, Tb, Tb^Tf, Ur, Xue, Xue, Uue^Qhux, Uue^Qhux, Uue^Qhux, Uhe, Xue, Xue, Xue, Xue, Uue^Qhux, Uue^Qhux, Xue, Xue, Xue, Xue, Ww, Xue, Xue, Xue, Xue
Xue, Xue, Uue, Uue, Tb^Tf, Tb, Tb^Tf, Tb^Tf, Tb^Tf, Tb, Tb, Tb^Tf, Uu^Qhh, Xu, Xue, Uu^Qhh, Cud^Dr, Xoa, Tb, Tb, Urb, Xue, Xue, Xue, Xue, Xue, Xue, Xue, Xue, Xue, Xue, Xue, Xue, Xue, Xue, Xue, Ww, Ww, Ww^Ii, Ww, Ww, Xue
Xue, Xue, Uhe, Uue, Tb^Tf, Uue, Uue, Uu^Qhh, Uu^Qhh, Uu, Uu^Qhh, Tb, Uu^Qhh, Uu^Qhh, Xu, Xoa, Uu^Vud, Tb^Tf, Urb, Cud^Qhh, Urb, Xoa, Xoa, Xue, Xue, Xue, Xoa, Xoa, Xoa, Xoa, Ql, Xoa, Xoa, Xu, Xue, Xue, Ww, Ww^Ewf, Ww, Ww^Ewf, Ww, Ww
Xue, Xue, Uhe, Uue, Tb, Tb, Uue, Uu^Qhh, Uu^Qhh, Uu^Qhh, Uu, Uu^Qhh, Tb^Tf, Uue, Xue, Xoa, Uu^Qhu, Urb, Tb^Tf, Urb, Urb^Dr, Uu^Qhu, Xoa, Xoa, Xoa, Ql, Uh^Qhh, Uu^Qhh, Xoa, Ql, Uh^Qhh, Uh^Qhh, Uh^Qhh, Xoa, Ds, Ds, Xu, Ww, Ww, Xue, Ds, Ww
Xue, Xue, Qxe, Uue, Uue, Tb^Tf, Tb, Tb^Tf, Tb^Tf, Uue, Uue, Uue, Uue, Uue, Xue, Xoa, Uu^Qhu, Urb, Tb^Qhu, Tb^Tf, Tb^Tf, Urb, Urb, Uh^Qhh, Uh^Qhh, Uh^Qhh, Uu^Dr, Uh^Qhh, Uu^Dr, Uu^Dr, Uu^Qhu, Tb^Tf, Ql, Tb^Tf, Uu, Xoa, Xoa, Xu, Xu, Ds, Uue, Ds
Xue, Xue, Qxe, Qxe, Uhe, Uhe, Tb^Tf, Uue, Tb^Tf, Sm, Tb^Tf, Tb, Tb, Uue, Xue, Xoa, Uu^Dr, Urb, Uu, Tb^Qhu, Ql, Tb^Tf, Uu, Urb, Uu^Vud, Uh^Qhh, Uu, Uu^Qhu, Uu^Qhu, Uu^Qhu, Tb, Tb^Tf, Tb^Tf, Tb^Tf, Uu, Uu^Vud, Cud^Qhh, Uh^Qhu, Uh^Qhu, Tb^Tf, Tb^Tf, Xue
Xue, Xue, Xue, Qxe, Xue, Uhe, Sm, Sm, Sm, Sm, Ds, Tb, Uue, Xue, Xue, Xoa, Ql, Urb, Uu, Tb^Qhu, Tb^Tf, Tb^Tf, Uu^Vud, Urb, Kud^Qhh, Uu, Uu^Vud, Uu, Uu, Tb^Tf, Tb, Tb^Tf, Tb^Tf, Tb, Uu^Dr, Uu, Uh^Qhu, Uh^Qhu, Qxu, Uu, Tb^Tf, Xue
Xu, Xue, Xue, Qxe, Xue, Xue, Xue, Xue, Ww, Ww, Ww, Ds, Uhe, Xue, Xue, Xue, Xoa, Urb, Uu, Tb^Tf, Tb^Tf, Tb^Tf, Urb, Cud^Qhh, Uu^Vud, Cud^Qhh, Uu, Uu, Tb^Tf, Tb^Tf, Ql, Tb, Tb, Uu, Uh, Xoa, Xu, Qxu, Uu, Uu^Dr, Tb, Tb^Tf
Uu^Qhh, Xu, Xu, Qxu, Xu, Xue, Xue, Xue, Xue, Ww^Ewf, Ww^Ii, Ds, Uhe, Xue, Xue, Xue, Ql, Urb, Urb^Dr, Uu, Urb, Urb, Uu^Vud, Cud^Qhh, Cud^Qhh, Cud^Qhh, Uu^Vud, Uu^Qhu, Uu^Qhu, Tb^Tf, Tb^Tf, Tb^Tf, Tb^Tf, Uh, Uh, Xoa, Xu, Xu, Cte, Uu, Tb, Tb^Tf
Uu^Qhh, Uu^Qhh, Uu^Qhh, Uu^Qhh, Cte, Cte, Qxe^Bh\, Qxe, Xue, Ww, Ww, Ds, Uue^Qhu, Xue, Xue, Xoa, Urb, Urb, Cud^Qhh, Urb, Uu^Qhh, Uu^Qhh, Tb^Tf, Uu, Uu^Vud, Uu^Br\, Uu^Br\, Uh^Dr, Tb^Tf, Uu^Qhu, Tb^Tf, Uu^Vud, Uu, Xoa, Xoa, Xoa, Xu, 4 Kte, Cte, Tb^Tf, Uh, Tb^Tf
Tb^Qhh, Tb^Qhh, Uu^Qhh, Uu^Qhh, Xu, Xue, Qxe, Cte^Dr, Cte, Wot, Ds, Ds, Ur, Ur, Ur, Tb^Qhu, Tb^Tf, Tb^Tf, Tb^Qhu, Uu^Qhu, Cud^Qhh, Uu^Qhh, Tb^Tf, Tb^Tf, Tb, Uu, Uh, Uu^Br\, Uu^Br\, Tb, Uu^Br/, Uu^Dr, Cud^Qhh, Uh, Xoa, Xu, Xu, Xu, Uu, Uu, Uh, Uh
Tb^Qhh, Tb^Qhh, Cte, Uu, Xu, Xue, Qxe, Xue, Xue, Wot, Ww, Ur, Uue^Qhu, Tb^Tf, Tb, Tb^Tf, Sm, Tb, Tb, Tb^Tf, Tb^Tf, Xoa, Xoa, Tb, Tb^Tf, Tb^Tf, Uh, Uu^Dr, Xoa, Uu^Br/, Xoa, Uu^Br\, Uu^Qhu, Uu^Qhu, Uu, Uh, Xu, Ds, Ds, Ds, Ds, Uh
Tb^Qhh, Uu^Qhh, Cte, 7 Kte, Cte, Cte, Xue, Xue, Xue, Xue, Ww^Ewf, Ur, Uue^Qhu, Tb, Sm, Tb^Tf, Tb, Sm, Tb^Tf, Sm, Tb, Tb^Tf, Xue, Ql, Xoa, Xoa, Tb, Xoa, Xu, Xoa, Uu^Qhu, Tb^Qhu, Tb^Dr, Tb^Dr, Uu, Uh, Uh, Ds, Qxu, Qxu, Qxu, Uu
Uu^Qhh, Uu^Qhh, Uu^Qhh, Cte, Xu, Xu, Xu, Xue, Xue, Xue, Ww, Ur, Tb^Tf, Tb^Tf, Qxe, Tb^Tf, Tb^Tf, Tb, Tb, Tb^Tf, Tb^Tf, Tb, Xue, Xue, Xue, Xue, Xoa, Xoa, Xue, Xu, Uu^Qhu, Tb^Tf, Tb, Tb^Tf, Uu, Uu, Uu, Uh, Qxu, Qxe, Tb^Tf, Uu
Sm, Uu, Sm, Uu^Qhh, Uu^Qhh, Uu^Qhh, Sm, Ss, Ww, Ww, Ww, Ur, Tb, Tb, Qxe, Qxe, Tb, Tb^Tf, Tb^Tf, Tb^Tf, Tb^Tf, Qxe, Qxe, Xue, Xue, Xue, Xue, Xue, Xue, Xu, Uu^Qhu, Uu^Qhu, Uu, Uu, Uue^Qhh, Tb^Tf, Uu^Qhh, Xu, Xu, Qxu, Tb^Tf, Uu
Ww, Sm, Ww, Sm, Ds, Ds, Ss, Ss, Ww^Ii, Ds, Ds, Ur, Tb^Tf, Xue, Xue, Qxe, Tb^Tf, Uue, Uue, Uue, Uue, Qxe, Qxe, Xue, Xue, Xue, Xue, Xue, Xue, Xue, Xue, Xu, Uue^Qhh, Uue^Qhh, Uue^Qhh, Uue^Qhh, Uue^Qhh, Xue, Xue, Xu, Tb, Tb^Tf
Ww, Ww^Ewf, Ww^Ii, Ww, Ww, Ds, Ww, Ww^Ewf, Ww, Ww, Ds, Ur, Uue, Xue, Xue, Xue, Uue^Qhu, Uue^Qhu, Uhe^Qhu, Xue, Uue, Qxe, Xue, Xue, Xue, Xue, Xue, Xue, Xue, Xue, Cte, Cte^Dr, Xue, Uue^Qhh, Uue, Uue, Ds, Xue, Xue, Tb^Tf, Tb, Tb^Tf
Ww, Ds, Ds, Ds, Ds, Ww^Bp|, Ww, Ww, Ww, Sm, Ur, Ur, Ss, Sm, Xue, Xue, Xue, Uue^Qhu, Xue, Xue, Xue, Cte, Cte, Xue, Xue, Xue, Xue, Xue, Cte^Dr, Cte, Xue, Xue, Qxe, Uhe, Uhe, Uhe, Ds, Ww, Ww, Ww, Ww, Tb^Tf
Ds, Ds, Sm^Qhu, Sm^Qhu, Sm^Qhu, Ds, Xue, Ww^Ewl, Sm, Sm, Ur, Tb^Tf, Ss, Ss, Sm, Xue, Xue, Cte, Xue, Xue, Xue, Xue, Uue^Qhu, Uue^Qhu, Uue^Qhu, Uue^Qhu, Uue^Qhu, Cte, Xue, Xue, Qxe, Qxe, Uhe, Uhe, Uue, Uue, Ds, Ww^Bw\r, Ds, Ds, Ww^Ii, Ww
Ss^Qhux, Ds, Uhe^Qhh, Ds, Ds, Xue, Xue, Xue, Ss, Ss, Ur, Tb, Tb, Tb^Tf, Tb, Sm, Ss, Uue, Xue, Xue, Xue, Xue, Uue^Qhu, Tb^Tf, Tb, Tb^Tf, Tb^Tf, Xue, Xue, Xue, Xue, Qxe, Xue, Ds, Ds, Ds, Ww, Ww^Ewf, Xu, Uu^Br\, Xu, Ww
Ss^Qhux, Ss^Qhux, Ss^Qhux, Uhe^Qhh, Ds, Ss^Qhux, Xue, Xue, Ur, Ur, Tb, Sm^Qhu, Sm^Qhu, Sm^Qhu, Tb, Tb^Tf, Sm, Sm, Uue^Qhh, Uue^Qhh, Uue, Xue, Uue^Qhu, Tb^Tf, Tb, Tb, Tb^Tf, Tb^Tf, Xue, Xue, Xue, Xue, Xue, Ww, Ww, Ds, Ww^Ii, Ww, Xu, Uu^Br|, Xu, Xu
Tb^Tf, Ss^Qhux, Ss^Qhux, Ds^Ewsh, Cte, Ss^Qhux, Ss^Qhux, Ur, Sm^Qhu, Sm^Qhu, Tb^Tf, Ss, Ss, Ss, Tb^Tf, Uue^Qhh, Uue^Qhh, Uue^Qhh, Uue, Uue, Uue, Uhe, Uue^Qhu, Uue^Qhu, Tb^Tf, Sm^Qhux, Tb^Tf, Tb^Tf, Uue, Xue, Xue, Xue, Xue, Ww, Ww, Ww, Ww^Ewf, Ww, Xu, Uu^Br|, Uu, Xu
Ss^Qhux, Tb^Tf, Tb^Qhux, Ds, 6 Kte, Cte, Ur, Ur, Sm^Qhu, Ds, Tb, Tb^Tf, Sm^Qhu, Ss, Sm, Tb^Qhh, Tb^Tf, Uhe, Tb^Tf, Tb^Tf, Tb^Tf, Uhe, Uue, Uue^Dr, Uue, Cte, Uue, Uue, Uue, Xue, Qxe, Xue, Sm, Ww, Sm, Wot, Wot, Xu, Xu, Sm^Qhu, Xu, Xu
Ss^Qhux, Ss^Qhux, Tb, Ds, Ds, Ds, Tb, Ds^Ewsh, Ss, Tb^Tf, Tb^Tf, Tb, Xue, Xue, Tb^Tf, Tb^Qhh, Tb, Tb^Tf, Tb^Tf, Tb^Tf, Sm^Qhux, Tb, Tb, Tb^Tf, Cte, 5 Kte, Cte, Uue, Uue, Uue, Qxe, Qxe, Ds, Sm, Ds, Sm, Wot, Xu, Gs^Efm, Gs, Gs^Fds, Xu
Ss, Ss, Ss, Tb^Tf, Tb^Tf, Sm^Qhux, Tb^Tf, Tb^Tf, Ss, Tb, Sm, Sm, Xue, Xue, Tb^Tf, Tb^Qhh, Tb^Tf, Sm^Qhux, Sm^Qhux, Tb^Tf, Tb^Tf, Tb, Tb^Tf, Tb^Tf, Uue^Vu, Cte, Uue^Qhh, Uue, Uhe, Uhe, Uhe, Qxe, Uue, Ds, Xu, Xu, Gs^Fds, Wwf, Gs, Rp, Gs^Fds, Xu
Ww, Ww, Ds, Ss, Ss, Ss, Ss, Ss, Tb^Tf, Tb, Sm, Wwt, Xue, Uue^Qhh, Uue^Qhh, Uue^Qhh, Tb, Tb^Tf, Sm^Qhux, Sm^Qhux, Tb, Tb^Tf, Uue, Uue, Uue^Qhh, Uue^Qhh, Xue, Uue^Qhh, Uue^Qhh, Uhe, Uhe, Uhe, Uue, Uu^Qhux, Xu, Mv, Sm^Gvs, Wwf, Gs^Efm, Rp, Gs^Fds, Xu
Ds, Ww, Ds, Tb^Tf, Tb, Tb^Tf, Tb, Ss, Tb^Tf, Sm, Wwt, Wwt, Xue, Uue^Qhh, Tb^Tf, Tb^Tf, Tb^Tf, Sm^Qhux, Tb, Tb, Tb^Tf, Tb^Tf, Uue^Qhh, Uue^Qhh, Uhe^Qhh, Xue, Xue, Xue, Uhe^Qhh, Uhe^Qhh, Uhe^Qhh, Uue^Qhh, Uue^Qhh, Uu^Qhux, Xu, Gs^Fds, Sm^Gvs, Sm^Gvs, 8 Rp, Rp, Gs^Fds, Xu
Ds, Ww, Ww, Ds, Ww, Ww^Ewl, Ww, Tb, Wwt, Wwt, Xue, Xue, Uhe^Qhh, Uue^Qhh, Tb, Ss^Qhux, Ss^Qhux, Ss^Qhux, Tb^Tf, Tb, Tb^Tf, Uue^Qhh, Uhe^Qhh, Uhe^Qhh, Xue, Xue, Xue, Uhe^Qhh, Uhe^Qhh, Uhe^Qhh, Xue, Xue, Xue, Uu^Qhux, Xu, Gg^Fet, Gs^Fds, Gs^Vd, Gs, Mv, Gs^Fds, Xu
Ds, Ds, Ds, Ww, Ds, Ww, Ww, Wwt, Uue, Wwt, Xue, Xue, Uue^Qhh, Uue^Qhh, Tb^Tf, Tb^Tf, Tb^Tf, Ss^Qhux, Sm, Sm, Uue, Uue^Qhh, Uue^Qhh, Xue, Xue, Xue, Xue, Xue, Xue, Xue, Xue, Xue, Xue, Xue, Xu, Xu, Xu, Xu, Xu, Xu, Xu, Xu
