Uhe, Uhe, Uhe, Qlf, Uhe, Uhe, Qlf, Qlf, Qlf, Xue, Xue, Xue, Xue, Xue, Xue, Xue, Xue, Xue, Xue, Ur, Uhe^Qhh, Rd, Uhe^Qhh, Uue, Uue, Uue, Uue, Uue, Qlf, Uue, Uue, Dd, Qlf, Qlf, Uue, Uhe, Uhe^Qhh, Qlf, Uhe^Qhh, Uhe, Uhe^Qhh, Uhe
Uhe, Uhe, Qlf, Qlf, Tb^Tf, Tb^Tf, Tb^Tf, Qlf, Qlf, Qlf, Qlf, Xue, Xue, Xue, Xue, Xue, Xue, Xue, Xue, Ur, Uhe^Qhh, Tb^Tf, Tb^Tf, Uhe^Qhh, Uue, Uue, Ur, Uue, Qlf, Mv, Qlf, Qlf, Tb^Tf, Qlf, Uue, Uhe^Qhh, Ur, Qlf, Uhe, Uhe^Qhh, Uhe^Qhh, Uhe
Ur, Uhe, Qlf, Tb^Tf, Uhe, Tb^Tf, Mv, Uhe, Uhe, Urb^Vd, Qlf, Xue, Xue, Xue, Xue, Xue, Xue, Xue, Uhe^Qhh, Ur, Uhe^Qhh, Tb^Tf, Tb^Tf, Uhe^Qhh, Ur, Ur, Qlf, Qlf^Bcx\, Urb^Vd, Qlf, Qlf, Uue, Qlf, Tb^Tf, Ur, Ur, Qlf, Qlf^Bcx\, Urb^Vd, Uhe, Uhe^Qhh, Uhe
Ur, Uhe, Qlf, Qlf, Qlf, Qlf, Qlf, Qlf, Qlf^Bcx/, Ur, Qlf, Xue, Xue, Xue, Xue, Xue, Xue, Uhe^Qhh, Urb^Vd, Ur, Uhe^Qhh, Co, Co, Co, Uhe^Qhh, Uhe^Qhh, Qlf, Qlf, Uue, Ur, Qlf^Bcx\, Qlf, Qlf^Bcx/, Ur, Uhe^Qhh, Qlf, Qlf, Uhe, Uhe, Uhe, Uhe^Qhh, Uhe
Ur, Tb^Tf, Tb^Tf, Qlf, Qlf, Qlf, Qlf^Bcx/, Ur, Qlf, Qlf, Uhe, Xue, Xue, Xue, Xue, Xue, Tb^Tf, Uhe^Qhh, Uue, Ur, Ur, Co, 2 Ko, Co, Qlf, Qlf, Uhe, Qlf, Qlf, Qlf, Mv, Ur, Qlf, Qlf, Qlf, Qlf, Qlf, Uhe, Uhe^Qhu, Uue, Uue, Uhe
Uue, Ur, Ur, Uhe, Ur, Uhe, Qlf, Qlf, Co, Qlf, Qlf, Uhe, Xue, Xue, Xue, Xue, Uhe^Qhh, Uue, Urb^Vd, Ur, Tb^Tf, Mv, Ur, Mv, Qlf, Uhe, Qlf, Qlf, Qlf, Qlf, Qlf, Qlf, Qlf, Urb^Vd, Qlf, Qlf, Uhe, Uhe, Uhe^Qhu, Uue, Uue, Uhe
Ur, Ur, Qlf, Ur, Uhe, Ur, Co, Qlf^Bcx/, Uhe^Qhu, Ur, Ur, Qlf, Xue, Mv, Xue, Xue, Tb^Tf, Uhe^Qhh, Ur, Ur, Uhe^Qhh, Uhe^Qhh, Ur, Uhe^Qhh, Qlf, Qlf, Uhe, Mv, Uue, Uue, Uue, Uhe, Uue, Uue, Uhe, Uhe, Uhe^Qhu, Uhe^Qhu, Xue, Xue, Xue, Uhe
Qlf, Urb^Vd, Qlf, Qlf, Ur, Ur, Qlf^Bcx\, Qlf, Uhe^Qhu, Uue^Qhu, Uhe^Qhu, Qlf, Qlf, Uue, Xue, Tb^Tf, Uhe^Qhh, Uhe^Qhh, Ur, Uhe^Qhh, Uue, Uue, Qlf, Qlf^Bcx\, Qlf^Bcx\, Urb^Vd, Ur, Uue, Uhe^Qhu, Uhe^Qhu, Uhe^Qhu, Uue, Uue, Uue, Uhe^Qhu, Xue, Xue, Xue, Xue, Xue, Xue, Xue
Qlf, Qlf, Uhe, Qlf, Ur, Uhe^Qhu, Qlf, Qlf^Bcx\, Ur, Uue^Qhu, Qlf, Qlf, Uue, Qlf, Ur, Tb^Tf, Uhe^Qhh, Uhe^Qhh, Ur, Ur, Qlf, Qlf, Mv, Ur, Ur, Ur, Uhe^Qhu, Uhe^Qhu, Tb^Tf, Tb^Tf, Tb^Tf, Uhe^Qhu, Uhe^Qhu, Xue, Xue, Xue, Xue, Xue, Xue, Xue, Xue, Xue
Qlf, Uhe, Qlf, Qlf, Ur, Uhe^Qhu, Qlf, Uhe^Qhu, Uue^Qhu, Qlf^Bcx\, Qlf^Bcx\, Qlf, Qlf, Qlf, Ur, Uue^Qhu, Uue^Qhu, Uue^Qhu, Ur, Co, Qlf, Qlf, Uue, Uhe^Qhu, Ur, Uue, Uhe^Qhu, Tb^Tf, Uue, Tb^Tf, Tb^Tf, Xue, Xue, Xue, Xue, Xue, Qlf, Xue, Xue, Xue, Xue, Xue
Uue, Qlf, Qlf, Uhe, Ur, Uhe^Qhu, Qlf, Uhe^Qhu, Uhe^Qhu, Uhe^Qhu, Qlf, Urb^Vd, Ur, Ur, Tb^Tf, Ur, Ur, Ur, Ur, Qlf, Qlf, Qlf, Uhe^Qhh, Uue, Ur, Ur, Ur, Uue, Uhe^Qhu, Tb^Tf, Xue, Xue, Xue, Xue, Qlf, Qlf, Qlf, Qlf, Xue, Xue, Xue, Xue
Uhe, Mv, Qlf, Ur, Qlf, Qlf, Qlf, Mv, Qlf, Qlf, Qlf, Qlf, Ur, Tb^Tf, Tb^Tf, Uhe^Qhh, Uhe^Qhh, Qlf, Qlf, Co, Qlf^Bcx\, Qlf, Ur, Uhe^Qhu, Ur, Uue, Uue, Ur, Uhe^Qhu, Uhe^Qhu, Mv, Xue, Qlf, Qlf, Qlf, Xue, Xue, Xue, Xue, Xue, Xue, Xue
Tb^Tf, Uhe, Qlf, Qlf, Qlf, Uhe, Uhe, Qlf, Qlf, Qlf, Co, Co, Co, Uhe^Qhh, Urb^Vd, Mv, Qlf, Qlf, Uhe, Qlf, Qlf, Urb^Vd, Uhe^Qhh, Ur, Uue, Ur, Ur, Ur, Ur, Ur, Ur, Xue, Xue, Qlf, Qlf, Xue, Xue, Xue, Xue, Xue, Xue, Xue
Uhe, Tb^Tf, Uhe, Urb^Vd, Ur, Qlf, Qlf, Qlf, Qlf^Bcx/, Qlf^Bcx/, Co, Ko, Co, Qlf, Qlf, Qlf, Qlf, Qlf, Qlf, Uhe, Uhe, Qlf, Qlf, Uhe^Qhh, Uhe, Uue, Ur, Urb^Vd, Uhe^Qhh, Tb^Tf, Xue, Ur, Ur, Xue, Qlf, Qlf, Ur, Xue, Ur, Xue, Ur, Ur
Tb^Tf, Tb^Tf, Tb^Tf, Uhe, Uhe, Ur, Ur, Urb^Vd, Qlf, Qlf, Uue, Ur, Ur, Qlf, Uhe^Qhh, Uhe^Qhh, Tb^Tf, Uhe^Qhh, Uue, Qlf, Qlf, Qlf, Qlf, Qlf, Uhe, Uhe^Qhu, Ur, Uhe^Qhh, Uhe^Qhh, Tb^Tf, Xue, Xue, Xue, Ur, Ur, Qlf^Bcx/, Qlf, Ur, Xue, Ur, Xue, Xue
Xue, Xue, Tb^Tf, Tb^Tf, Uhe, Uhe, Ur^Pr|o, Uhe, Qlf, Qlf, Qlf, Uhe^Qhh, Qlf, Qlf^Bcx\, Qlf^Bcx\, Uhe^Qhh, Uue, Qlf, Qlf, Co, Qlf, Mv, Mv, Qlf, Uue, Ur, Urb^Vd, Uhe^Qhh, Uhe^Qhh, Tb^Tf, Cte, Xue, Ur, Ur, Qlf, Qlf, Qlf, Xue, Xue, Xue, Xue, Xue
Xue, Xue, Xue, Xue, Xue, Xue, Ur, Xue, Xue, Mv, Uhe^Qhh, Qlf, Qlf, Qlf, Qlf, Ur, Ur, Qlf, Qlf, Qlf, Qlf, Qlf, Qlf, Qlf, Ur, Ur, Uue, Uue, Uue, Cte, 4 Kte, Cte, Xue, Qlf, Qlf, Qlf, Mv, Qlf, Xue, Xue, Xue, Xue
Xue, Xue, Xue, Xue, Xoa, Xoa, Ur^Qhu, Xoa, Xoa, Xue, Xue, Uhe^Qhh, Tb^Tf, Urb^Vd, Ur, Ur, Uue^Qhu, Ur, Ur, Ur, Qlf, Qlf, Qlf^Bcx/, Qlf^Bcx/, Uue, Ur, Urb^Vd, Uue, Uue, Cte, Cte, Xue, Xue, Xue, Xue, Xue, Xue, Xue, Xue, Xue, Xue, Xue
Xue, Xue, Xoa, Xoa, Xoa, Co^Qhu, Ur^Qhu, Co^Qhu, Xoa, Xoa, Xoa, Xue, Xue, Tb^Tf, Uhe^Qhh, Uhe^Qhh, Tb^Tf, Uhe^Qhh, Urb^Vd, Qlf^Bcx\, Ur, Qlf^Bcx/, Qlf, Qlf, Qlf, Ur, Uhe^Qhh, Uhe^Qhh, Tb^Tf, Uhe, Xue, Xue, Xue, Xue, Xue, Xue, Xue, Xue, Xue, Xue, Xue, Xue
Xue, Xoa, Urb^Qhu, Co^Qhu, Urb^Qhu, Isa^Qhu, Mv^Qhu, Isa^Qhu, Urb^Qhu, Co^Qhu, Urb^Qhu, Xoa, Xue, Xue, Xue, Uhe^Qhh, Uhe^Qhh, Uhe^Qhh, Uhe^Qhh, Qlf, Qlf^Bcx|, Qlf, Qlf, Uue, Qlf, Ur, Uue^Qhu, Uhe^Qhh, Tb^Tf, Tb^Tf, Xue, Xue, Xue, Xue, Xue, Xue, Xue, Xue, Xue, Xue, Xue, Xue
Xue, Xoa, Urb, Urb, Urb, Isa, Isa, Isa, Urb, Urb, Urb, Xoa, Xue, Xue, Xue, Xue, Tb^Tf, Uhe^Qhh, Uhe^Qhh, Ur, Ur, Co, Qlf, Qlf, Ur, Ur, Uue^Qhu, Uhe^Qhh, Uhe^Qhh, Tb^Tf, Xue, Xue, Xue, Xue, Xue, Xue, Xue, Xue, Xue, Xue, Xue, Xue
Xue, Xoa, Xoa, Urc^Qhh, Urc^Qhh, Urb, Urb^Qhh, Urb, Urc^Qhh, Urc^Qhh, Xoa, Xue, Xue, Xue, Xue, Tb^Tf, Tb^Tf, Uhe^Qhh, Uhe^Qhh, Uhe^Qhh, Uue, Ur, Ur, Qlf^Bcx/, Co, Ur, Ur, Ur, Ur, Uhe^Qhh, Xue, Xue, Xue, Xue, Xue, Xue, Xue, Xue, Xue, Xue, Xue, Xue
Xue, Xue, Xue, Xoa, Co^Qhh, Urc^Qhh, Urc^Qhh, Urc^Qhh, Co^Qhh, Xoa, Xue, Xue, Xue, Xue, Xue, Xue, Tb^Tf, Tb^Tf, Uhe^Qhh, Uhe^Qhh, Uue, Uue, Ur, Qlf, Qlf, Uhe^Qhh, Uhe^Qhh, Uhe^Qhh, Ur, Uhe^Qhh, Mv, Xue, Xue, Xue, Xue, Xue, Xue, Xue, Xue, Xue, Xue, Xue
Xue, Xue, Xue, Xue, Xoa, Co^Qhh, Ko^Qhh, Co^Qhh, Xoa, Xoa, Xue, Xue, Xue, Xue, Xue, Xue, Tb^Tf, Tb^Tf, Urb^Vd, Uue, Uue, Ur, Qlf, Qlf, Qlf, Qlf, Urb^Vd, Ur, Uhe^Qhh, Ur, Uue^Qhu, Xue, Xue, Xue, Xue, Xue, Xue, Xue, Xue, Xue, Xue, Xue
Xue, Xue, Xue, Xue, Xue, Xoa, Xoa, Xoa, Xue, Xue, Xue, Xue, Xue, Xue, Xue, Tb^Tf, Tb^Tf, Tb^Tf, Tb^Tf, Tb^Tf, Uue, Ur, Urb^Vd, Qlf, Mv, Qlf, Qlf, Uhe^Qhh, Uhe^Qhh, Ur, Ur^Qhu, Uue^Qhu, Xue, Xue, Xue, Xue, Xue, Xue, Xue, Xue, Xue, Xue
Xue, Xue, Xue, Xue, Xue, Xue, Xue, Xue, Xue, Xue, Xue, Xue, Xue, Xue, Xue, Tb^Tf, Uhe^Qhh, Uue, Uhe^Qhh, Uhe^Qhh, Ur, Ur, Qlf, Qlf, Qlf, Qlf, Qlf, Uhe^Qhh, Tb^Tf, Tb^Tf, Tb^Tf, Ur^Qhu, Ur^Qhu, Xue, Xue, Xue, Xue, Xue, Xue, Xue, Xue, Xue
Xue, Xue, Xue, Xue, Xue, Xue, Xue, Xue, Xue, Xue, Xue, Xue, Xue, Xue, Xue, Xue, Uhe^Qhh, Uue, Ur, Ur, Ur, Qlf, Uhe, Qlf, Uue, Uue, Uhe^Qhh, Uhe^Qhh, Tb^Tf, Tb^Tf, Tb^Tf, Uhe^Qhh, Uhe^Qhh, Ur^Qhu, Xue, Xue, Xue, Xue, Xue, Xue, Xue, Xue
Xue, Xue, Xue, Xue, Xue, Xue, Xue, Xue, Xue, Xue, Xue, Xue, Xue, Xue, Xue, Xue, Ur, Ur, Uhe^Qhh, Uhe^Qhh, Ur, Qlf, Qlf, Qlf, Uhe^Qhh, Uhe^Qhh, Uhe^Qhh, Uhe^Qhh, Uhe^Qhh, Uhe^Qhh, Ur, Uhe^Qhh, Ur, Ur, Uue, Xue, Xue, Xue, Xue, Xue, Xue, Xue
Xue, Xue, Xue, Xue, Xue, Xue, Xue, Xue, Xue, Xue, Xue, Xue, Xue, Xue, Xue, Ur, Urb^Vd, Uue, Uhe^Qhh, Ur, Qlf, Qlf, Qlf, Mv, Qlf, Qlf, Qlf, Qlf, Qxu^Bcx/, Qxu^Bcx/, Urb^Vd, Ur, Qlf, Ur, Ur, Co, 3 Ko, Co, Uhe^Qhh, Mv, Uhe^Qhh, Uhe^Qhh
Xue, Xue, Xue, Xue, Xue, Xue, Xue, Xue, Xue, Xue, Xue, Xue, Xue, Xue, Xue, Ur, Uue, Uue^Qhu, Ur, Ur, Ur, Qlf, Qlf, Qlf, Ur, Ur, Ur, Ur, Urb^Vd, Qlf, Qlf, Qlf, Qlf, Qlf, Uhe^Qhh, Co, Co, Co, Uhe^Qhh, Uhe^Qhh, Uhe^Qhh, Uhe^Qhh
Xue, Xue, Xue, Xue, Xue, Xue, Xue, Xue, Xue, Xue, Xue, Xue, Xue, Xue, Xue, Ur, Uhe^Qhh, Uhe^Qhh, Cte, Qlf, Qlf, Qlf^Bcx\, Ur, Ur, Uhe^Qhh, Uhe^Qhh, Uhe^Qhh, Uue^Em, Uue, Uhe^Qhh, Qlf, Qlf, Mv, Qlf, Qlf, Uhe^Qhh, Ur, Ur, Urb^Vd, Uhe^Qhh, Qlf, Uhe^Qhh
Xue, Xue, Xue, Xue, Xue, Xue, Xue, Xue, Xue, Xue, Xue, Xue, Xue, Xue, Uue, Ur, Ur, Ur, Qlf, Qlf, Qlf, Uhe^Qhh, Uhe^Qhh, Ur, Tb^Tf, Tb^Tf, Tb^Tf, Uue^Em, Uhe^Qhh, Uhe^Qhh, Uhe^Qhh, Qlf, Uhe^Qhh, Uhe^Qhh, Qlf, Qlf, Qlf^Bcx|, Qlf, Qlf, Qlf, Qlf, Uhe^Qhh
Xue, Xue, Xue, Xue, Xue, Xue, Xue, Xue, Xue, Xue, Xue, Xue, Uue^Qhu, Uue, Uue, Urb^Vd, Ur, Qlf, Qlf, Uhe, Qlf, Uhe^Qhh, Uhe^Qhh, Ur, Tb, Tb^Tf, Uhe^Qhh, Xue, Xue, Uhe^Qhh, Uhe^Qhh, Uhe^Qhh, Uue, Uue^Emf, Uue, Uhe^Qhh, Ur^Qhu, Mv, Uhe^Qhh, Qlf, Qlf, Uhe^Qhh
Tb^Tf, Xue, Xue, Xue, Xue, Xue, Xue, Xue, Xue, Xue, Xue, Uue^Qhu, Uue, Mv, Cte, Ur, Uue, Ur, Qlf^Bcx\, Qlf, Qlf, Mv, Uue, Ur, Tb, Tb^Tf, Uhe^Qhh, Tb, Tb^Tf, Xue, Tb, Tb^Tf, Urb^Vd, Tb^Tf, Uhe^Qhh, Uue^Qhu, Uhe^Qhh, Ur^Qhu, Ur^Qhu, Qlf, Qlf, Qlf
Tb^Tf, Tb^Tf, Uhe^Qhh, Xue, Xue, Xue, Xue, Xue, Xue, Xue, Xue, Uue, Uue, Cte, 6 Ke, Cte, Uue, Qlf, Qlf, Qlf^Bcx\, Urb^Vd, Uue, Ur, Ur, Ur, Uhe^Qhh, Wwr^Qhu, Wwr^Qhu, Ww^Qhu, Ss, Ss, Ss, Tb^Tf, Tb^Tf, Xue, Xue, Xue, Uhe^Qhh, Uhe, Ur, Qlf, Qlf
Uhe, Uhe^Qhh, Urb^Vd, Xue, Xue, Xue, Xue, Xue, Xue, Tb^Tf, Tb, Uhe^Qhh, Ur, Cte, Cte, Cte, Urb^Vd, Qlf, Qlf, Qlf, Tb, Ur, Uue^Qhu, Uue, Uhe^Qhh, Urb^Vd, Wwr^Bw\, Wwr^Qhu, Ww^Qhu, Ww^Qhu, Ss, Ss^Ii, Tb, Tb, Xue, Xue, Xue, Uhe^Qhh, Uhe^Qhh, Ur, Urb^Vd, Qlf
Qlf, Qlf, Qlf, Uhe^Qhh, Uhe^Qhh, Uhe^Qhh, Uhe^Qhh, Uhe^Qhh, Uhe, Uhe, Ur, Ur, Qlf, Qlf, Qlf, Qlf, Qlf, Qlf, Qlf, Tb, Uue, Ur, Uue^Emf, Uue, Xue, Ss, Ss, Ss^Bw\, Ss^Bw\, Ss^Bw/, Ss^Bw\, Ss, Tb, Tb^Tf, Xue, Xue, Xue, Xue, Xue, Uhe, Qlf, Qlf
Qlf, Qlf, Mv, Qlf, Cer, Cer, Cer, Uhe^Qhh, Urb^Vd, Ur, Uhe^Qhh, Qlf, Uhe, Uhe, Qlf, Qlf, Mv, Uhe, Qlf, Tb^Tf, Tb^Tf, Ur, Uhe^Qhh, Uhe^Qhh, Xue, Tb^Tf, Tb, Ss, Ss^Ii, Ss, Tb^Tf, Ss, Ss, Tb^Tf, Wwr^Qhu, Xue, Xue, Xue, Xue, Xue, Xue, Qlf
Uhe, Qlf, Qlf, Uue, Uue^Vct, 1 Kerg, Cer, Uhe^Qhh, Uhe, Ur, Uhe^Qhh, Qlf, Qlf, Qlf, Co^Vd, Qlf, Qlf, Uhe, Qlf, Uhe^Qhh, Ur, Ur, Xue, Xue, Xue, Tb^Tf, Tb^Tf, Tb, Tb^Tf, Tb^Tf, Tb^Tf, Tb^Tf, Wwr^Qhu, Wwr^Qhu, Ww^Qhu, Xue, Wwrt^Cov, Xue, 5 Cme^Kov, Xue, Xue, Xue
Uhe, Uhe, Tb^Tf, Uhe^Qhh, Uhe^Qhh, Uue^Vct, Uue, Ur, Ur, Ur, Qlf, Uue, Uue, Qlf, Uue, Qlf, Uhe, Qlf, Qlf, Uhe^Qhh, Urb^Vd, Uhe^Qhh, Xue, Xue, Xue, Xue, Xue, Urb^Vd, Xue, Tb^Tf, Xue, Xue, Xue, Xue, Xue, Ww, Wo, Wwrt^Cov, Wwrt^Cov, Wwrt^Cov, Wo, Xue
Uhe, Tb^Tf, Tb^Tf, Tb^Tf, Uhe^Qhh, Uhe^Qhh, Uhe^Qhh, Cte, Qlf, Qlf, Qlf, Uue, Tb^Tf, Uue, Mv, Qlf, Qlf, Uhe, Qlf, Uhe^Qhh, Uhe^Qhh, Uhe^Qhh, Xue, Xue, Xue, Xue, Xue, Xue, Xue, Xue, Xue, Xue, Xue, Xue, Wo, Wo, Wo, Wo, Wo, Wo, Wo, Wo
Uue, Tb^Tf, Tb^Tf, Tb^Tf, Uhe, Uhe^Qhh, Uhe, Ur, Uue, Mv, Qlf, Uue, Uue, Uue, Qlf, Qlf, Gs, Qlf, Qlf, Uhe^Qhh, Uhe^Qhh, Uhe^Qhh, Xue, Xue, Xue, Xue, Xue, Xue, Xue, Xue, Xue, Xue, Xue, Wo, Wo, Wo, Wo, Wo, Wo, Wo, Wo, Wo
