Xu, Xu, Xu, Xu, Xu, Xu, Ur, Uu, Uu, Uu, Uu, Uu, Uu, Mv, Ql, Ql, Ql, Ql, Ql, Ql, Ql^Bcx/, Uu, Ur, Uu, Uu, Uu, Xu, Xu, Xu, Xu, Xu, Xu
Xu, Xu, Xu, Xu, Xu, Xu, Ur, Uu, Xu, Xu, Uh^Tf, Xu, Xu, Uu, Ql, Ql, Ql, Ql, Ql^Bcx/, Ql^Bcx/, Mv, Ur, Uu^Vd, Uu, Uu^Qhu, Uu, Xu, Xu, Xu, Xu, Xu, Xu
Ql, Xu, Xu, Ql, Ql, Ur, Ur, Uu, Xu, Uh^Tf, Tb, Uh^Tf, Tb, Xu, Uh^Tf, Ql, Ql^Bcx/, Ql^Bcx/, Ql, Ql, Xu, Uu, Uu^Qhu, Uu^Qhu, Xu, Xu, Xu, Xu, Xu, Xu, Xu, Xu
Ql, Ql, Ql, Ql, Ql, Ur, Uu^Qhu, Ur, Ur, Uh^Tf, Ql, Tb, Tb, Uue, Uu, Ur^Tf, Co, Co, Co, Xu, Xu, Xu, Xu, Xu, Xu, Xu, Xu, Xu, Xu, Xu, Xu, Xu
Ql, Ql, Ql, Ql, Ql, Ur, Uu^Qhu, Xu, Xu, Uu^Vd, Ql^Bcx\, Uh^Tf, Uu^Vd, Uue^Emf, Uu^Qhu, Uh^Tf, Co, 2 Ko, Uu^Qhu, Uu^Qhu, Uu, Uu^Vd, Uh^Qhh, Xu, Xu, Xu, Xu, Xu, Xu, Xu, Xu, Xu
Ur, Ql, Ql, Ql, Ur, Ur, Xu, Mv, Xu, Xu, Ql, Ql^Bcx\, Ur, Uh^Tf, Uu^Qhu, Uu^Qhu, Ur^Qhu, Ur^Qhu, Xu, Xu, Uh^Qhh, Uh^Qhh, Uu, Xu, Xu, Ql, Mv, Xu, Xu, Xu, Xu, Xu
Ur, Uu^Vd, Ur, Ur, Uu^Qhu, Uu^Qhu, Xu, Xu, Xu, Xu, Ql, Ql, Ql, Ur, Ur, Ur^Qhu, Uu^Vd, Xu, Xu, Uu, Uu, Xu, Uu, Uu, Uu^Vd, Ql, Ql, Mv, Xu, Tb^Tf, Tb^Tf, Xu
Ql, Ur, Ql, Ur, Ur, Uu^Qhu, Xu, Xu, Xu, Xu, Uh, Uu, Uu, Uue^Emf, Ur, Mv, Xu, Xu, Xu, Xu, Xu, Uh^Qhh, Xu, Xu, Ql^Bcx|, Ql, Ql, Ql, Uu, Cte, Cte, Xu
Ql, Ql, Ql, Ql, Uu^Qhu, Ur, Ur, Qxu, Uu, Uu, Uh, Uu, Uu, Uue, Ur, Uh^Qhh, Xu, Xu, Xu, Xu, Xu, Xu, Ql, Ql, Ql^Bcx|, Ql, Ql, Ql, Uu, 4 Kte, Cte, Xu
Ql, Ql, Ql, Uu, Uu^Qhu, Uu^Vd, Uue^Emf, Qxu^Bcx\, Ur, Uu, Uh, Uh, Uu, Uh, Ur, Uh^Qhh, Uu, Uh^Qhh, Uu, Xu, Xu, Xu, Mv, Mv, Ql^Bcx|, Ql, Ql, Uh^Vu, Uh^Qhh, Uh^Qhh, Uh^Qhh, Uh
Xu, Xu, Uu, Uu^Qhu, Uu, Uu, Qxu, Qxu, Uu, Ur, Ur, Uh^Qhh, Uh^Qhh, Uh, Uh^Vd, Ur, Xu, Xu, Xu, Qxu^Bp\, Uu, Xu, Ql, Ql, Ql^Bcx|, Ql, Uue, Tb^Tf, Tb^Tf, Uu^Vo, Ur, Ur
Xu, Xu, Uu, Uu, Qxu, Qxu, Uu, Uu, Uu^Qhu, Uue, Uh^Qhh, Ur, Ur, Uh^Qhh, Ur, Ur, Uh, Xu, Uh, Xu, Uu, Uu, Tb^Tf, Tb^Tf, Uu, Ql, Uue, Ss^Qhu, Tb, Tb^Tf, Ur, Tb^Tf
Xu, Xu, Xu, Qxu, Xu, Xu, Xu, Xu, Uue, Uue, Uh^Qhh, Uu, Uh, Ur, Uue, Ur, Ur, Uu, Uh^Qhh, Tb^Tf, Xu, Xu, Xu, Tb^Tf, Tb^Tf, Uu^Vu, Uue, Ss^Qhu, Tb, Ur, Tb, Tb^Tf
Xu, Xu, Xu, Xu, Uue, Uue, Uhe, Xu, Uue, Uh, Uh^Qhh, Uh^Qhh, Uh^Qhh, Uue, Uu^Qhu, Uue^Emf, Uue, Ur, Cer, Tb^Tf, Xu, Xu, Uh, Tb, Tb, Uu, Uue, Uue, Ur, Ur, Tb, Tb
Xu, Xu, Xu, Xu, Uue, Uue, Xu, Xu, Xu, Uue, Uue, Uue, Uh^Qhh, Uue, Uu^Qhu, Uu, Uue, Ur, Ker, Cer, Xu, Xu, Uh, Xu, Tb^Tf, Uu, Ur, Ur, Ss^Qhu, Ss^Qhu, Tb^Tf, Tb^Tf
Xu, Xu, Xu, Xu, Uue, Uue, Uhe, Xu, Xu, Xu, Xu, Uue, Uue, Uu^Vu, Uu, Uu^Qhu, Uu, Ur, Ur, Tb^Tf, Tb, Tb^Tf, Tb^Tf, Tb^Tf, Ur, Ur, Uu, Uu, Tb^Tf, Xu, Xu, Xu
Xu, Xu, Xu, Xu, Uhe, Uue, Uue, Xu, Xu, Uue^Dr, Xu, Xu, Xu, Xu, Uu, Uu^Qhu, Uu^Qhu, Uu, Ur, Uu, Tb, Tb^Tf, Ss^Qhu, Xu, Ur, Uhe, Uu, Tb^Tf, Xu, Xu, Cte, Xu
Xu, Xu, Xu, Xu, Ss^Qhu, Uue, Uue, Uue, Uue, Ss^Qhu, Uhe, Xu, Xu, Xu, Xu, Uh, Uh, Uu^Qhu, Uue, Ur, Ur, Ss^Qhu, Ur, Xu, Ur, Uhe, Uu, Xu, Xu, Uh, Cte, Xu
Xu, Xu, Xu, Xu, Xu, Uue, Uue^Ii, Ss^Qhu, Cte^Qhh, Cte, Cte^Qhu, Uue^Dr, Xu, Xu, Uue^Dr, Xu, Xu, Uh, Uu, Uue^Emf, Tb^Tf, Ur, Tb^Tf, Ur, Ur, Uhe, Uu, Xu, Uh, Uh, Cte, Xu
Xu, Xu, Xu, Xu, Xu, Uhe, Uue, Ss^Qhu, Cte^Qhu, 5 Kte, Cte^Qhh, Ss^Qhu, Ss^Qhu, Uue, Uue, Xu, Xu, Uh, Uu, Uu, Tb, Tb, Ss^Qhu, Uu, Ur, Uhe, Uhe, Xu, Xu, Cte, Kte, Xu
Xu, Xu, Xu, Xu, Xu, Xu, Xu, Ss^Qhu, Uhe, Cte, Uue^Dr, Ss^Qhu, Uue^Ii, Xu, Ss^Qhu, Ss^Qhu, Uue^Dr, Xu, Uu, Tb^Tf, Tb^Tf, Tb, Uu^Emf, Tb^Tf, Uu^Vu, Ur, Uhe, Uu^Vu, Xu, Xu, Xu, Xu
Xu, Xu, Xu, Xu, Xu, Xu, Xu, Uue, Xu, Uue^Dr, Uue, Xu, Xu, Ss^Qhu, Ss^Qhu, Xu, Uue, Xu, Xu, Xu, Tb^Tf, Uu^Emf, Tb^Tf, Tb, Tb, Cte, Cte, Cte, Xu, Xu, Xu, Xu
Xu, Xu, Xu, Xu, Xu, Xu, Xu, Xu, Xu, Xu, Xu, Ss^Qhu, Xu, Uue^Dr, Xu, Uue, Xu, Xu, Xu, Tb^Tf, Uu^Vu, Tb^Tf, Ss^Qhu, Tb, Uu^Vu, Cte, 3 Kte, Tb^Tf, Tb, Tb^Tf, Xu, Xu
Xu, Xu, Xu, Xu, Xu, Xu, Xu, Xu, Xu, Xu, Xu, Xu, Xu, Xu, Xu, Xu, Xu, Uh^Qhh, Uu, Uu^Emf, Tb^Tf, Ss^Qhu, Uue, Ss^Qhu, Tb^Tf, Tb^Tf, Ur, Uu, Ss^Qhu, Tb^Tf, Xu, Xu
Xu, Xu, Xu, Xu, Xu, Xu, Uu^Vct, Xu, Xu, Xu, Xu, Uh, Uu, Uu, Tb^Tf, Tb^Tf, Tb^Tf, Uu^Emf, Tb, Uu, Uu, Uue, Uu^Qhh, Uu, Ur, Ur, Tb, Ss^Qhu, Tb^Tf, Tb^Tf, Xu, Xu
Xu, Xu, Xu, Xu, Xu, Xu, Uu^Vct, Cer, Cer, Cer, Uu, Uu, Tb, Uu, Tb, Uu^Qhh, Tb, Tb^Tf, Tb^Tf, Ss^Qhh, Ur, Uu, Ur, Ur, Uu^Qhh, Tb^Tf, Tb^Tf, Tb, Uu, Tb^Tf, Uh, Xu
Xu, Xu, Xu, Xu, Xu, Xu, Uu^Vct, Cer, 1 Ker, Tb^Tf, Tb^Tf, Tb, Uu, Uu, Ur, Uu^Vu, Ur, Tb, Ur, Ur, Qxu^Bp\, Ur, Uu^Qhu, Uu, Uu, Uu, Uu, Tb^Tf, Uh, Uh, Uh, Xu
Xu, Xu, Xu, Xu, Xu, Uu, Uu, Tb^Tf, Tb^Tf, Ur, Ur, Uu, Ur, Ur, Tb, Ur, Uu^Qhu, Ur, Qxu, Uu, Qxu, Ur, Ur, Qxu, Qxu, Qxu, Qxu, Uh, Xu, Xu, Xu, Xu
Xu, Xu, Xu, Xu, Xu, Uu, Tb^Tf, Uu, Ur, Ur, Xu, Ur, Ss^Qhh, Uu, Tb, Uu^Qhu, Uu^Qhu, Uu^Qhu, Tb^Tf, Qxu, Qxu, Qxu, Ur, Uu^Vu, Qxu^Bp\, Qxu, Uh^Qhu, Xu, Xu, Xu, Xu, Xu
Xu, Xu, Xu, Xu, Tb^Tf, Uu, Ur, Ur, Xu, Xu, Xu, Xu, Xu, Tb^Tf, Tb^Tf, Uu, Uu^Qhu, Uu, Tb^Tf, Qxu, Qxu, Qxu, Ur, Qxu, Qxu, Uh^Qhu, Xu, Xu, Xu, Xu, Xu, Xu
Xu, Xu, Xu, Uu, Ur, Ur, Xu, Xu, Xu, Xu, Xu, Xu, Xu, Tb^Tf, Tb^Tf, Uu, Uu^Qhu, Tb^Tf, Tb^Tf, Qxu, Qxu, Ur, Qxu, Qxu, Qxu, Uh^Qhu, Xu, Xu, Xu, Xu, Xu, Xu
Xu, Xu, Xu, Uu, Ur, Uu, Xu, Xu, Xu, Xu, Xu, Xu, Gd, Tb^Tf, Tb^Tf, Tb^Tf, Tb^Tf, Tb^Tf, Tb^Tf, Qxu, Qxu, Ur, Ur, Qxu, Qxu, Uh^Qhu, Xu, Xu, Xu, Xu, Xu, Xu
