Gll^Fp, Gll^Fp, Gll^Fp, Hh^Fp, Hh^Fp, Hh, Mm, Mm, Mm^Xm, Xu, Xu, Uu, Tb^Tf, Uu, Uu, Qxu, Uu, Uu, Uu, Uu, Xu, Uu, Uu, Uu, Uu, Xu, Uu, Rr, Rr^Br/
Gll^Fp, Gll^Fp, Gll^Fp, Gll^Fp, Hh^Fp, Hh, Mm, Mm^Xm, Mm^Xm, Xu, Tb^Tf, Tb^Tf, Tb^Tf, Uu^Vu, Uh, Qxu^Bp\, Ker, Uu, Uu^Qhh, Uu, Xuc, Tb^Tf, Uu, Uh^Ii, Uu, Uu, Rr^Br/, Rr^Br/, Uu
Hh, Hh, Gll^Fp, Gll^Fp, Gll^Fp, Hh, Hh^Fp, Mm, Hh^Qhu, Uu^Qhu, Xu, Tb^Tf, Tb^Tf, Uh, Uu, Qxu^Bp\, Cer, Cer, Uu^Qhh, Uue, Xu, Uue, Uh^Tf, Uu, Rr^Br/, Rr^Br/, Uh, Uh, Uu
Gll^Fp, Gll^Fp, Gll^Fp, Gll^Fp, Gs^Efm, Gll^Fp, Hh^Fp, Hh^Qhuf, Hh^Qhuf, Mm^Xm, Mm^Xm, Xu, Xu, Xu, Xu, Qxu, Xu, Uu^Vu, Xu, Uu^Vu, Xu, Xu, Xu, Uu, Rr^Br|, Uu, Uu, Uh, Uh
Gll^Fp, Gll^Fp, Gll, Gll, Gs, Gs, Gll^Fp, Hh^Fp, Gll^Fp, Hh, Mm, Mm^Xm, Mm^Xm, Mm^Xm, Mm^Xm, Xu, Mm^Xm, Xu, Mm^Xm, Xu, Mm^Xm, Xu, Xu, Cud, Cud, 2 Kud^Br\, Uu, Uu, Uh
Gll^Fp, Gll^Fp, Gs^Efm, Gs, Gg^Efm, Gg^Efm, Gs, Gg, Gll^Fp, Gll^Fp, Gll^Fp, Hh^Fp, Gll^Fp, Hh, Gll^Fp, Mm^Xm, Hh^Vhh, Mm^Xm, Mm, Mm^Xm, Mm^Xm, Xu, Re^Qhu, Re^Qhu, Re^Br/, Cud^Br/, Cud, Uu, Uu
Hh^Qhh, Hh^Qhh, Gg, Gs, Gs, Gs, Gg, Gg, Gg, Gg, Gg, Gll^Fp, Gs, Gll^Fp, Gs^Fp, Gll^Fp, Hh, Hh, Hhd, Md, Hhd, Hhd, Re^Br/, Re^Br/, Xu, Xu, Uu, Uu, Uh
Gs^Fp, Gs^Fp, Gg, Gs, Gs, Gs, Gs, Gs, Re, Gs, Gg, Gs, Gg^Es, Gs, Gg^Wm, Ss^Qhu, Ss^Qhu, Hh, Cud^Vud, Hhd, Re^Br/, Re^Br/, Md, Xu, Mm^Xm, Xu, Xu, Uu, Uu
Gg, Gg, Gs, Gs, Gs, Gs, Gs, Gs, Gs, Re, Gs, Gs^Es, Gg, Gs, Gg, Ss^Qhu, Gg, Ss^Qhu, Re, Re^Br\, Cud^Vud, Hhd, Hhd, Md, Mm, Mm^Xm, Mm^Xm, Xu, Xu
Gg^Efm, Gs, Gs, Gs, Gg, Gs, Gg, Gg, Gs, Gg, Re, Gg, Gg^Vhr, Gg^Efm, Gg^Efm, Gg, Gg^Esd, Re, Gg, Ss^Qhu, Ss^Qhu, Hhd, Mm, Mm, Mm, Mm, Mm, Mm^Xm, Mm^Xm
Gg, Gs, Re, Re, Gg, Gg, Gg, Gg, Gs, Gg^Efm, Gg^Efm, Re, Gg, Gg^Esd, Rp, Gs, Re, Re, Gg^Efm, Ss^Qhu, Ss^Qhu, Hh, Mm, Mm, Hh, Hh, Hh, Hh, Mm
Gs, Gg, Re, Gg, Gg, Gg^Efm, Gg^Efm, Gg, Gll^Fp, Gg, Gll, Gs, Gs, Gs, Gg, Rp, Gg, Rp, Rp, Gg, Gg^Esd, Gg, Hh, Hh, Mm, Mm, Mm, Mm, Mm
Gs, Gg, Re^Vhr, Gg, Gll, Gs^Efm, Gll^Fp, Gll^Fp, Gll^Fp, Gs^Vhr, Gll^Fp, Gs^Fp, Gs^Fp, Gs^Fp, Gll^Fp, Gg^Esd, Gg, Gg^Vhr, Gg, Gg^Efm, Gg, Gg^Efm, Hh, Hh, Hh, Mm, Mm, Mm, Mm
Gg, Gg, Gg, Gg, Gll, Gll^Fp, Hh^Fp, Gg^Fet, Hh^Fp, Gll^Fp, Hh^Fp, Gll^Fp, Gll^Fp, Gll^Fp, Gll^Fp, Gll, Gll^Efm, Gg^Efm, Gg, Rp, Gg, Gg^Efm, Gg^Efm, Hh, Hh, Hh, Hh, Hh, Hh
Gg, Gs, Gg, Gg, Hh^Fp, Hh^Fp, Mm, Hh, Hh, Hh^Fp, Hh, Hh, Mm, Hh^Fet, Hh^Fp, Gll^Fp, Gll^Fp, Gg^Efm, Gg^Efm, Rp, Rp, Gg, Gg, Gll, Gs, Gll^Fp, Hh^Fp, Hh, Hh^Fp
Gg, Gs, Gg, Gg^Efm, Hh, Mm, Mm, Mm, Mm, Mm, Hh, Mm, Mm, Mm, Mm, Hh, Mm, Hh, Hh, Hh, Gg, Gg, Gg, Gs, Gs, Gs^Fp, Gll^Fp, Hh^Fp, Hh^Fp
Gs, Gs^Es, Gg, Hh, Hh, Mm, Mm, Mm, Mm, Mm, Hh, Mm, Mm, Mm, Mm, Mm, Mm, Mm, Hh, Hh, Gg, Re, Re, Gg, Gs, Gll^Fp, Gll^Fp, Gll^Fp, Gll^Fp
Gg, Gg, Gg, Gg, Gll^Fp, Hh, Hh, Mm, Mm, Mm, Hh, Hh, Mm, Mm, Mm, Mm, Mm, Mm, Mm, Hh, Hh, Gg, Rp, Gll, Gll, Gll^Fp, Gg^Fet, Gll^Fp, Gll^Fp
Gs, Gs, Gg, Gll^Fp, Hh^Fp, Hh, Hh, Hh, Hh^Fp, Hh, Hh, Mm, Mm, Mm, Mm, Mm, Mm, Mm, Mm, Hh, Gg, Gs, Rp, Gs, Gs, Gll^Fp, Gll^Fp, Gll^Fp, Gll^Fp
Gs, Gs, Gs, Gll^Fp, Hh^Fp, Hh^Fp, Hh^Fp, Hh^Fp, Hh^Fet, Hh^Fp, Hh^Fp, Hh, Hh, Mm, Hh, Hh, Hh, Mm, Hh, Hh, Gg, Gs, Gs, Gs, Gs, Gs^Vct, Hh^Fp, Gll^Fp, Gll^Fp
Gs, Gs, Gs, Gg^Fet, Gll^Fp, Gs, Hh^Fp, Hh^Fp, Gll^Fp, Gs^Vhr, Gll^Fp, Gll, Gll^Fp, Hh, Gg, Hh, Gg, Hh, Gg, Gg, Re, Re, Gs, Gs, Gs, Hh, Mm, Hh, Hh
Gs, Gs, Gs, Gs, Re, Gll^Fp, Gs, Gg, Gs, Gs^Fp, Gg, Gll^Fet, Re, Gg, Gg, Gg, Rp, Rp, Rp, Re, Gg, Gs, Hh^Fp, Gs, Hh, Mm, Mm, Mm, Mm
Gs, Gs, Gs, Gs, Gs, Gs, Gs, Gs, Re, Gg, Re, Re, Gg, Re, Gg, Rp, Gg^Efm, Gg^Efm, Gg, Gg, Gg, Gll^Fp, Hh^Fp, Hh^Fp, Mm, Hh, Hh, Mm, Mm
Gs, Gs, Gs, Gs, Gs, Gs, Gs, Re, Gs^Edt, Gs, Gg, Gs^Edb, Gg, Gs, Gg, Gg, Gg^Efm, Gs^Vhr, Gg, Gs, Gll^Fp, Gll^Fp, Gll^Fp, Hh, Mm, Mm, Hh, Hh, Hh
Gs, Gs, Gs, Gs, Cer, Cer, Cer, Gs, Gg, Gs, Gs, Gs, Gg^Vhr, Gg^Edt, Gs, Gg, Gs, Gs, Gg^Efm, Gs, Gs^Fp, Gs^Fp, Hh, Hh, Hh, Hh, Mm, Mm, Mm
Gs, Gs, Gs, Gs, Cer, 1 Kerg, Cer, Gs, Gll, Gll, Gll, Gll, Gll^Fp, Gs, Gll, Gll, Gg, Gg^Efm, Gg^Efm, Gs, Hh, Hh, Mm, Mm, Mm, Mm^Xm, Mm^Xm, Ms^Xm, Mm
Gs, Gs, Gs, Gs, Gs, Cer, Gs, Gs, Gll^Fp, Gs, Gll^Fp, Gll^Fp, Gll^Fp, Gll^Fp, Gll^Fp, Gll^Fp, Gg^Fet, Gll, Gg, Gg^Efm, Mm, Hh, Hh, Mm, Mm, Mm^Xm, Mm^Xm, Mm^Xm, Mm^Xm
Gs, Gs, Gll^Edb, Gs, Gll^Fp, Gs, Gll^Fp, Gll^Fp, Gll^Fp, Gll^Fp, Gg^Fet, Gll^Fp, Gll^Fp, Gll^Fet, Gll^Vht, Gll^Fp, Gll^Fp, Gll^Fp, Gll, Gg^Efm, Mm, Hh, Hh, Mm, Ms^Xm, Mm^Xm, Ms^Xm, Mm, Mm^Xm
Gd, Gd, Gd, Gll^Fp, Gll^Fp, Gll^Fp, Gll^Fp, Gll^Fp, Gll^Fp, Gll^Fp, Gll^Fp, Gll^Fp, Gs^Fp, Gll^Fp, Gg, Gll^Fp, Gll^Fp, Gll^Fp, Gg, Gg^Efm, Mm, Hh, Hh, Mm, Mm, Ms^Xm, Mm^Xm, Mm^Xm, Mm^Xm
