Ur, Tb^Tf, Tb^Tf, Uue, Uhe, Tb^Tf, Tb^Tf, Uue, Uue, Tb^Tf, Tb^Tf, Uue, Uue, Uu, Uu, Uu, Uu, Uu, Uu, Uu, Uh, Xu, Xue, Xue, Uhe, Uue, Tb^Tf, Tb^Tf, Xue, Uue, Uu, Uue, Uu, Xu, Xu, Xu, Xu, Xu, Xu, Xu, Xu, Xu
Tb^Tf, Ur, 1 Ur, Uue, Uhe, Tb^Tf, Xue, Tb^Tf, Tb^Tf, Uue, Tb^Tf, Tb^Tf, Uue, Uue, Uue, Uu, Uu, Uu, Uh, Uu, Uh, Xu, Xue, Xue, Uhe, Uhe, Tb^Tf, Tb^Tf, Uhe, Tb^Tf, Tb^Tf, Uu, Xu, Xu, Xu, Xu, Xu, Xu, Xu, Xu, Xu, Xu
Tb^Tf, Uu, Ur, Xue, Xue, Xue, Xue, Xue, Xue, Ds, Ds, Tb^Tf, Tb^Tf, Uue, Uue, Uue, Xu, Uu, Uh, Uh, Uh, Xu, Xue, Uhe, Uue, Uue, Uue, Tb^Tf, Tb^Tf, Tb^Tf, Uu, Uh, Xu, Xu, Xu, Xu, Xu, Tb^Tf, Uh, Tb^Tf, Xu, Xu
Tb^Tf, Uh, Xu, Ur, Xue, Sm, Ww, Ww, Xue, Ww, Ds, Sm, Tb^Tf, Uue, Uue, Xue, Xue, Xu, Uh, Xu, Xu, Xu, Xue, Uhe, Uue, Tb^Tf, Tb^Tf, Tb^Tf, Tb^Tf, Tb^Tf, Tb^Tf, Uh, Uh, Xu, Xu, Uu, Uu, Uh, Uu, Tb^Tf, Uu, Uu
Tb^Tf, Uu, Uu, Ur, Sm, Sm, Ww^Ewf, Ww^Ii, Ww, Ww, Tb^Tf, Tb^Tf, Tb^Tf, Tb^Tf, Xue, Xue, Xue, Xu, Cte, Xu, Xue, Xue, Uue, Uhe, Tb^Tf, Tb^Tf, Sm, Sm, Tb^Tf, Uue, Uue, Uh, Uh, Uu, Uu, Uu, Uu, Uh, Uue, Uu, Tb^Tf, Tb^Tf
Tb^Tf, Ds, Ds, Ur, Ww^Bp\, Ww, Ww, Ww, Ww, Ww, Tb^Tf, Tb^Tf, Tb^Tf, Ss, Sm, Xue, Xue, Cte^Vu, 2 Kte, Cte^Vu, Xue, Xue, Uue, Uue, Uue, Tb^Tf, Tb^Tf, Ss, Tb^Tf, Uue^Vu, Xue, Uhe, Uue, Cte, 3 Kte, Uu, Uue, Uue, Xue, Uhe, Uue, Xue
Ww, Ww, Ww^Ewf, Ds, Ds, Ww^Bp\, Sm^Bp\, Sm, Sm, Ds, Uue, Tb^Tf, Tb^Tf, Sm, Tb^Tf, Tb^Tf, Xue, Xue, Xue, Xue, Xue, Xue, Uue, Uue, Tb^Tf, Tb^Tf, Uue, Tb^Tf, Tb^Tf, Uue, Xue, Uhe, Uue, Cte, Cte, Cte, Uhe, Xue, Xue, Uhe, Uhe, Xue
Tb^Tf, Tb^Tf, Ds, Ww^Ii, Ww, Sm, Uue, Ur, Ur, Uue^Dr, Uue^Br\, Tb^Tf, Tb^Tf, Tb^Tf, Tb^Tf, Tb^Tf, Xue, Xue, Xue, Xue, Xue, Xue, Xue, Uue, Uue, Tb^Tf, Uue, Tb^Tf, Uue, Uhe, Uhe, Uhe, Uue, Uue, Tb^Tf, Uhe, Uhe, Xue, Xue, Uhe, Uhe, Xue
Tb^Tf, Tb^Tf, Uu, Ds, Ds, Sm, Xue, Xue, Uue, Ur, Ur, Uue^Br\, Uue^Br\, Tb^Tf, Ur, Tb^Tf, Ur, Uue, Uue, Uhe, Uhe, Xue, Uue, Uue, Uue, Uue, Uue^Vu, Uue, Uue, Uhe, Xue, Uhe, Uue, Uue^Vu, Uue, Uhe, Uue, Xue, Xue, Uue, Xue, Xue
Uh, Uu, Uu, Uu, Uue, Uue, Xue, Xue, Xue, Uue, Uue, Ur, Ur, Ur^Dr, Tb^Tf, Ur, Tb^Tf, Ur, Ur, Uue, Uhe, Uhe, Uue, Uue, Tb^Tf, Uue, Uue, Uue, Tb^Tf, Uue, Uue, Uue, Uue, Uue, Uue, Uue, Uue, Xue, Xue, Xue, Xue, Xue
Uh, Uh, Uu, Uu, Uue, Uue, Uue, Xue, Xue, Xue, Xue, Uue, Uue, Uue, Tb^Tf, Sm, Tb^Tf, Uhe, Uhe, Ur, Ur, Uue, Uue, Tb^Tf, Tb^Tf, Tb^Tf, Tb^Tf, Tb^Tf, Uue, Uue, Uue, Uue, Uhe, Uhe, Uhe, Xue, Xue, Cte, Xue, Xue, Xue, Xue
Xu, Xu, Uu, Uue, Uue, Uue, Uue, Xue, Xue, Xu, Xu, Xu, Xu, Xu, Uu, Tb^Tf, Tb^Tf, Tb^Tf, Tb^Tf, Uhe, Uhe^Dr, Ur, Uue, Uue, Tb^Tf, Tb^Tf, Tb^Tf, Uhe, Xue, Xue, Tb^Tf, Uhe, Uue, Uue, Uue, Xue, Xue, Cte^Vu, Xue, Xue, Xue, Xue
Xue, Xue, Uue, Tb^Tf, Tb^Tf, Uue, Tb^Tf, Tb^Tf, Xu, Uh, Uh, Uh, Xu, Xu, Uu, Uu, Tb^Tf, Tb^Tf, Tb^Tf, Tb^Tf, Ur, Ur, Uue, Uue, Uue, Tb^Tf, Uhe, Uhe, Xue, Xue, Xue, Uue, Uue, Uue, Uue, Xue, Xue, Cte, Xue, Xue, Xue, Xue
Xue, Xue, Uue, Tb^Tf, Tb^Tf, Tb^Tf, Tb^Tf, Xu, Xu, Tb^Tf, Tb^Tf, Uh, Uh, Xu, Uu, Uu, Tb^Tf, Tb^Tf, Tb^Tf, Tb^Tf, Ur, Xue, Xue, Uue, Uue, Uue, Uhe, Xue, Xue, Xue, Xue, Uue, Uue, Xue, Xue, Xue, Xue, Ww, Xue, Xue, Xue, Xue
Xue, Xue, Uue, Uue, Tb^Tf, Tb^Tf, Tb^Tf, Tb^Tf, Tb^Tf, Tb^Tf, Tb^Tf, Tb^Tf, Uu, Xu, Xue, Uu, Cud, Xoa, Tb^Tf, Tb^Tf, Urb, Xue, Xue, Xue, Xue, Xue, Xue, Xue, Xue, Xue, Xue, Xue, Xue, Xue, Xue, Xue, Ww, Ww, Ww^Ii, Ww, Ww, Xue
Xue, Xue, Uhe, Uue, Tb^Tf, Uue, Uue, Uu, Uu, Uu^Vu, Uu, Tb^Tf, Uu, Uu, Xu, Xoa, Uu^Vud, Tb^Tf, Urb, Cud, Urb, Xoa, Xoa, Xue, Xue, Xue, Xoa, Xoa, Xoa, Xoa, Xoa, Xoa, Xoa, Xu, Xue, Xue, Ww, Ww^Ewf, Ww, Ww^Ewf, Ww, Ww
Xue, Xue, Uhe, Uue, Tb^Tf, Tb^Tf, Uue, Uu, Uu, Uu, Uu^Vu, Uu, Tb^Tf, Uue, Xue, Xoa, Uu, Urb, Tb^Tf, Urb, Urb^Dr, Uu, Xoa, Xoa, Xoa, Xoa, Uh, Uu, Xoa, Uu, Uh, Uh, Uh, Xoa, Uu, Ds, Xu, Ww, Ww, Xue, Ds, Ww
Xue, Xue, Xue, Uue, Uue, Tb^Tf, Tb^Tf, Tb^Tf, Tb^Tf, Uue, Uue, Uue, Uue, Uue, Xue, Xoa, Uu, Urb, Tb^Tf, Tb^Tf, Tb^Tf, Urb, Urb, Uh, Uh, Uh, Uu^Dr, Uh, Uu^Dr, Uu^Dr, Uu, Tb^Tf, Sm, Tb^Tf, Uu, Xoa, Xoa, Xu, Xu, Ds, Uue, Ds
Xue, Xue, Xue, Xue, Uhe, Uhe, Tb^Tf, Uue, Tb^Tf, Sm, Tb^Tf, Tb^Tf, Tb^Tf, Uue, Xue, Xoa, Uu^Dr, Urb, Uu, Tb^Tf, Sm, Tb^Tf, Uu, Urb, Uu^Vud, Uh, Uu, Uu, Uu, Uu, Tb^Tf, Tb^Tf, Tb^Tf, Tb^Tf, Uu, Uu^Vud, Cud, Uh, Uh, Tb^Tf, Tb^Tf, Xue
Xue, Xue, Xue, Xue, Xue, Uhe, Sm, Sm, Sm, Sm, Ds, Tb^Tf, Uue, Xue, Xue, Xoa, Xoa, Urb, Uu, Tb^Tf, Tb^Tf, Tb^Tf, Uu^Vud, Urb, Kud, Uu, Uu^Vud, Uu, Uu, Tb^Tf, Tb^Tf, Tb^Tf, Tb^Tf, Tb^Tf, Uu^Dr, Uu, Uh, Uh, Uu, Uu, Tb^Tf, Xue
Xu, Xue, Xue, Xue, Xue, Xue, Xue, Xue, Ww, Ww, Ww, Ds, Uhe, Xue, Xue, Xue, Xoa, Urb, Uu, Tb^Tf, Tb^Tf, Tb^Tf, Urb, Cud, Uu^Vud, Cud, Uu, Uu, Tb^Tf, Tb^Tf, Sm, Tb^Tf, Tb^Tf, Uu, Uh, Xoa, Xu, Uu, Uu, Uu^Dr, Tb^Tf, Tb^Tf
Uu, Xu, Xu, Xu, Xu, Xue, Xue, Xue, Xue, Ww^Ewf, Ww^Ii, Ds, Uhe, Xue, Xue, Xue, Xoa, Urb, Urb^Dr, Uu, Urb, Urb, Uu^Vud, Cud, Cud, Cud, Uu^Vud, Uu, Uu, Tb^Tf, Tb^Tf, Tb^Tf, Tb^Tf, Uh, Uh, Xoa, Xu, Xu, Cte, Uu, Tb^Tf, Tb^Tf
Uu, Uu, Uu, Uu, Cte, Xue, Cte, Xue, Xue, Ww, Ww, Ds, Uue, Xue, Xue, Xoa, Urb, Urb, Cud, Urb, Uu, Uu, Tb^Tf, Uu, Uu^Vud, Uu^Br\, Uu^Br\, Uh^Dr, Tb^Tf, Uu, Tb^Tf, Uu^Vud, Uu, Xoa, Xoa, Xoa, Xu, 4 Kte, Cte, Tb^Tf, Uh, Tb^Tf
Tb^Tf, Tb^Tf, Uu, Uu, Xu, Cte, Xue, Cte, Cte, Ww, Ds, Ds, Ur, Ur, Ur, Tb^Tf, Tb^Tf, Tb^Tf, Tb^Tf, Uu, Cud, Uu, Tb^Tf, Tb^Tf, Tb^Tf, Uu, Uh, Uu^Br\, Uu^Br\, Tb^Tf, Uu^Br/, Uu^Dr, Cud, Uh, Xoa, Xu, Xu, Xu, Uu^Vu, Uu, Uh, Uh
Tb^Tf, Tb^Tf, Cte, Uu^Vu, Xu, Xue, Xue, Xue, Xue, Ww, Ww, Ur, Uue, Tb^Tf, Tb^Tf, Tb^Tf, Sm, Tb^Tf, Tb^Tf, Tb^Tf, Tb^Tf, Xoa, Xoa, Tb^Tf, Tb^Tf, Tb^Tf, Uh, Uu^Dr, Xoa, Uu^Br/, Xoa, Uu^Br\, Uu^Dr, Uu, Uu, Uh, Xu, Uu, Uu, Uu, Uu, Uh
Tb^Tf, Uu, Cte, 7 Kte, Xu, Xue, Xue, Xue, Xue, Xue, Ww^Ewf, Ur, Uue, Tb^Tf, Sm, Tb^Tf, Tb^Tf, Sm, Tb^Tf, Sm, Tb^Tf, Tb^Tf, Xue, Xoa, Xoa, Xoa, Tb^Tf, Xoa, Xu, Xoa, Uu, Tb^Tf, Tb^Tf, Tb^Tf, Uu, Uh, Uh, Uu, Uu, Uu, Uu, Uu
Uu, Uu, Uu, Cte, Xu, Xu, Xu, Xue, Xue, Xue, Ww, Ur, Tb^Tf, Tb^Tf, Tb^Tf, Tb^Tf, Tb^Tf, Tb^Tf, Tb^Tf, Tb^Tf, Tb^Tf, Tb^Tf, Xue, Xue, Xue, Xue, Xoa, Xoa, Xue, Xu, Uu, Tb^Tf, Tb^Tf, Tb^Tf, Uu, Uu, Uu, Uh, Uh, Xu, Tb^Tf, Uu
Sm, Uu^Vu, Sm, Uu, Uu, Uu, Sm, Ss, Ww, Ww, Ww, Ur, Tb^Tf, Tb^Tf, Xue, Xue, Tb^Tf, Tb^Tf, Tb^Tf, Tb^Tf, Tb^Tf, Xue, Xue, Xue, Xue, Xue, Xue, Xue, Xue, Xu, Uu, Uu, Uu, Uu, Uue, Tb^Tf, Uu, Xu, Xu, Xu, Tb^Tf, Uu
Ww, Sm, Ww, Sm, Ds, Ds, Ss, Ss, Ww^Ii, Ds, Ds, Ur, Tb^Tf, Xue, Xue, Xue, Tb^Tf, Uue, Uue, Uue, Uue, Xue, Xue, Xue, Xue, Xue, Xue, Xue, Xue, Xue, Xue, Xu, Uue, Uue, Uue, Uue, Uue, Xue, Xue, Xu, Tb^Tf, Tb^Tf
Ww, Ww^Ewf, Ww^Ii, Ww, Ww, Ds, Ww, Ww^Ewf, Ww, Ww, Ds, Ur, Uue^Vu, Xue, Xue, Xue, Uue, Uue, Uue, Xue, Uue, Xue, Xue, Xue, Xue, Xue, Xue, Xue, Xue, Xue, Cte, Cte, Xue, Uue, Uue, Uue, Ds, Xue, Xue, Tb^Tf, Tb^Tf, Tb^Tf
Ww, Ds, Ds, Ds, Ds, Ww^Bp|, Ww, Ww, Ww, Sm, Ur, Ur, Uue, Uhe, Xue, Xue, Xue, Uue, Xue, Xue, Xue, Cte, Cte, Xue, Xue, Xue, Xue, Xue, Cte, Cte, Xue, Xue, Uhe, Uhe, Uhe, Uhe, Ds, Ww, Ww, Ww, Ww, Tb^Tf
Ds, Ds, Uue, Uue, Uue, Ds, Xue, Ww, Sm, Sm, Ur, Tb^Tf, Uue, Uue, Uhe, Xue, Xue, Cte, Xue, Xue, Xue, Xue, Uue, Uue, Uue, Uue, Uue, Cte, Xue, Xue, Xue, Xue, Uhe, Uhe, Uue, Uue, Ds, Ww^Bw\r, Ds, Ds, Ww^Ii, Ww
Uue, Uue, Uhe, Uhe, Uue, Xue, Xue, Xue, Uue, Uue, Ur, Tb^Tf, Tb^Tf, Tb^Tf, Tb^Tf, Uhe, Uue, Uue, Xue, Xue, Xue, Xue, Uue, Tb^Tf, Tb^Tf, Tb^Tf, Tb^Tf, Xue, Xue, Xue, Xue, Xue, Xue, Ds, Ds, Ds, Ww, Ww^Ewf, Xu, Uu^Br\, Xu, Ww
Uue, Uue, Uue, Uhe, Uue, Uue, Xue, Xue, Ur, Ur, Tb^Tf, Sm, Sm, Sm, Tb^Tf, Tb^Tf, Uue, Uue, Uue, Uue, Uue, Xue, Uue, Tb^Tf, Tb^Tf, Tb^Tf, Tb^Tf, Tb^Tf, Xue, Xue, Xue, Xue, Xue, Ww, Ww, Ds, Ww^Ii, Ww, Xu, Uu^Br|, Xu, Xu
Tb^Tf, Uue, Uue, Uue^Vu, Cte, Uue, Uue, Ur, Uhe, Uhe, Tb^Tf, Ss, Ss, Ss, Tb^Tf, Uue, Uue, Uue, Uue, Uue^Vu, Uue, Uue, Uue, Uue, Tb^Tf, Sm, Tb^Tf, Tb^Tf, Uue, Xue, Xue, Xue, Xue, Ww, Ww, Ww, Ww^Ewf, Ww, Xu, Uu^Br|, Uu, Xu
Uue, Tb^Tf, Tb^Tf, Uhe, 6 Kte, Cte, Ur, Ur, Uhe, Uhe, Tb^Tf, Tb^Tf, Sm, Ss, Sm, Tb^Tf, Tb^Tf, Uue, Tb^Tf, Tb^Tf, Tb^Tf, Uue, Uue, Uue, Uue, Cte, Uue^Vu, Uue, Uue, Xue, Xue, Xue, Sm, Ww, Sm, Wot, Wot, Xu, Xu, Sm, Xu, Xu
Uue, Uue, Tb^Tf, Uhe, Uhe, Ur, Tb^Tf, Uue^Vu, Uue, Tb^Tf, Tb^Tf, Tb^Tf, Xue, Xue, Tb^Tf, Tb^Tf, Tb^Tf, Tb^Tf, Tb^Tf, Tb^Tf, Sm, Tb^Tf, Tb^Tf, Tb^Tf, Cte, 5 Kte, Cte, Uue, Uue, Uue, Uue, Uue, Uue, Sm, Uu, Sm, Wot, Xu, Gs, Gs, Gs^Fds, Xu
Uue, Tb^Tf, Tb^Tf, Tb^Tf, Tb^Tf, Sm, Tb^Tf, Tb^Tf, Uue, Tb^Tf, Uue, Uue, Xue, Xue, Tb^Tf, Tb^Tf, Tb^Tf, Sm, Sm, Tb^Tf, Tb^Tf, Tb^Tf, Tb^Tf, Tb^Tf, Uue^Vu, Cte, Uue, Uue, Uhe, Uhe, Uhe, Uhe, Uue, Uu, Xu, Xu, Gs^Fds, Wwf, Gs, Rp, Gs^Fds, Xu
Ww, Ww, Ds, Tb^Tf, Ss, Ss, Tb^Tf, Uue, Tb^Tf, Tb^Tf, Uue, Uhe, Xue, Uue, Uue, Uue, Tb^Tf, Tb^Tf, Sm, Sm, Tb^Tf, Tb^Tf, Uue, Uue, Uue, Uue, Xue, Uue, Uue, Uhe, Uhe, Uhe, Uue, Uu, Xu, Mv, Sm^Gvs, Wwf, Gs, Rp, Gs^Fds, Xu
Ds, Ww, Ds, Tb^Tf, Tb^Tf, Tb^Tf, Tb^Tf, Tb^Tf, Tb^Tf, Uhe, Uhe, Uhe, Xue, Uue, Tb^Tf, Tb^Tf, Tb^Tf, Sm, Tb^Tf, Tb^Tf, Tb^Tf, Tb^Tf, Uue, Uue, Uhe, Xue, Xue, Xue, Uhe, Uhe, Uhe, Uue, Uue, Uu, Xu, Gs^Fds, Sm^Gvs, Sm^Gvs, Rp, Rp, Gs^Fds, Xu
Ds, Ww, Ww, Ds, Ww, Ww, Ww, Tb^Tf, Tb^Tf, Uhe, Xue, Xue, Uue, Uue, Tb^Tf, Ss, Ss, Ss, Tb^Tf, Tb^Tf, Tb^Tf, Uue, Uhe, Uhe, Xue, Xue, Xue, Uhe, Uhe, Uhe, Xue, Xue, Xue, Uu, Xu, Gs^Fds, Gs^Fds, Gs^Vd, Gs, Mv, Gs^Fds, Xu
Ds, Ds, Ds, Ww, Ds, Ww, Ww, Tb^Tf, Uue, Uhe, Xue, Xue, Uue, Uue, Tb^Tf, Tb^Tf, Tb^Tf, Ss, Sm, Sm, Uue, Uue, Uue, Xue, Xue, Xue, Xue, Xue, Xue, Xue, Xue, Xue, Xue, Xue, Xu, Xu, Xu, Xu, Xu, Xu, Xu, Xu
