Ms, Ms, Ms, Ms, Ms, Ms, Ms, Ms, Ms, Gd, Ms, Ms, Ms, Ms, Aa^Fpa, Aa^Fpa, Aa^Fpa, Hhd, Ms, Ms, Ms, Ms, Ms, Ms, Ms, Ms, Ms, Aa, Ms, Aa^Fpa, Ms, Ms, Ms, Ms, Ms, Ms, Aa^Fpa, Ms, Ms, Ms, Ai, Aa, Ms, Ms, Ms, Ms, Ms, Ms
Ms, Ms, Ms, Ms, Ms, Ms, Ms, Ms, Ms, Ms, Ms, Ms, Ms, Ms, Ms, Ms, Ms, Ms, Ms, Ms, Ms, Ms, Ms, Ms, Ms, Ms, Ms, Ms, Ms, Ms, Aa^Fpa, Aa^Fpa, Aa^Fpa, Aa^Fpa, Ms, Aa^Fpa, Aa, Ai, Aa, Aa, Ai, Ha, Ha, Ms, Ms, Ms, Ms, Gd
Ms, Ms, Ms, Ms, Ms, Ms, Ms, Ms, Ms, Ms, Ms, Ms, Ms, Ms, Aa^Fpa, Ms, Ms, Ms, Ms, Ms, Ms, Ms, Ms, Ms, Aa^Fpa, Ms, Ms, Ms, Ha, Ms, Ms, Aa^Vha, Ha, Ha^Fpa, Ha^Fpa, Aa, Ai, Ai, Cha, Aa, Aa, Ai, Ai, Aa^Fpa, Ms, Ms, Ms, Gd
Ms, Ms, Ms, Ms, Ms, Ms, Ms, Ms, Aa^Fpa, Ms, Ms, Ms, Ms, Ms, Ms, Ms, Ms, Ms, Ms, Ms, Ms, Ms, Ms, Aa^Fpa, Ms, Ha, Ms, Ha, Aa^Fpa, Ha, Ha^Fpa, Ha^Fpa, Aa, Ha, Aa, Aa, Ai, Cha, Kha^Vhca, Cha, Aa, Ai, Ms, Ha^Fpa, Ha, Ms, Ms, Gll^Fp
Ms, Ms, Ms, Ms, Ms, Ms, Ms, Ms, Aa^Fpa, Ms, Ms, Ms, Aa^Fpa, Aa^Fpa, Ms, Ms, Ms, Ms, Ms, Ms, Ms, Ms, Aa^Fpa, Ha, Aa, Aa^Fpa, Aa, Aa^Fpa, Ai, Aa, Aa, Aa, Ai, Aa, Ai, Ai, Cha, 3 Kha, Kha, Cha, Aa, Ai, Ms, Ms, Ms, Ms, Ms, Ms
Ms, Ms, Ms, Ms, Ms, Ms, Ms, Ms, Aa^Fpa, Ms, Ms, Ms, Aa^Fpa, Ms, Ms, Ms, Ms, Ms, Ms, Ms, Ms, Ms, Ha^Fpa, Aa^Fpa, Ai, Ai, Ai, Ai, Ai, Ai, Ai, Ai, Ai, Ai, Ai, Ai, Rra, Cha, Cha, Cha, Ai, Ai, Ms, Ms, Ha^Fma, Ms, Ms, Ms
Ms, Ms, Ms, Ms, Ms, Ms, Ms, Ms, Aa^Fpa, Ms, Ms, Ms, Aa^Fpa, Ms, Ms, Ms, Ms, Ms, Ms, Ms, Ms, Ms, Aa, Aa, Ai, Ai, Ai, Ai, Ai, Ai, Ai, Ai, Ai, Ai, Ms, Rra, Aa^Fpa, Ai, Ai, Ai, Ms, Ms, Ms, Ms, Ms, Ha, Ms, Ms
Ms, Ms, Ms, Ms, Ms, Ms, Ms, Cte^Vu, Cte, Aa^Fpa, Cte^Qhu, Aa^Vu, Ms, Ms, Ms, Ms, Ai, Ai, Ai, Ha^Fpa, Aa^Fpa, Ha^Fpa, Aa^Vhha, Ai, Ai, Ai, Ai, Ai, Ai, Ai, Ai, Ai, Ms, Ha^Vla, Rra, Rra, Aa^Fpa, Aa^Fpa, Ha^Fpa, Ha^Fpa, Aa^Fpa, Aa^Fma, Ha^Fma, Aa^Fma, Ha, Ms, Ms, Ms
Ms, Ms, Ms, Ha, Ms, Ms, Ms, Cte^Qhh, Cte^Qhh, 4 Kte, Cte, Ms, Aa, Ms, Ms, Ha, Ha, Aa, Ha^Fpa, Ai, Ai, Aa^Fpa, Ai, Ai, Ai, Ai, Ai, Ai, Aa, Ai, Aa^Fpa, Aa^Fpa, Ha, Ha^Fpa, Rra, Aa^Fpa, Ha^Fpa, Aa^Fpa, Ms, Ms, Ms, Ms, Ms, Ha, Ms, Ms, Ms, Ms
Ms, Ms, Ms, Ha, Ms, Ms, Ms, Aa^Fpa, Ms, Cte^Qhh, Re^Qhu, Aa^Fpa, Aa, Ms, Ha, Ha, Ha, Ha, Ha^Fpa, Ms, Ai, Ai, Ai, Ai, Aa, Ai, Aa, Aa, Aa, Aa, Aa, Ms, Rra, Rra, Aa^Fpa, Aa^Fpa, Ms, Ms, Ms, Ms, Ms, Ms, Ms, Ms, Ms, Ms, Ms, Ms
Ms, Ms, Ha, Ha, Ha, Ms, Ms, Aa^Fpa, Ms, Ms, Ms, Re^Qhu, Re^Qhu, Aa^Voa, Ms, Ms, Ms, Ms, Ai, Ai, Ai, Ai, Aa, Aa, Aa, Aa, Ha, Ms, Aa^Fpa, Aa, Aa, Aa^Fpa, Rra, Aa^Fpa, Ms, Aa^Fpa, Aa^Fpa, Ms, Ms, Ms, Ms, Ms, Ms, Ms, Ms, Ms, Ms, Ms
Ms, Ms, Ms, Ms, Ms, Ms, Ms, Ms, Aa^Fpa, Ms, Ms, Ms, Aa, Re^Qhu, Ms, Ms, Ww, Ai, Ai, Ai, Ai, Ha, Ha, Aa, Aa, Aa, Aa^Fpa, Aa^Fpa, Aa^Vha, Ms, Rra, Rra, Ms, Aa^Fpa, Aa^Fpa, Aa^Fpa, Aa^Fpa, Ms, Ms, Ms, Ms, Ms, Ms, Ms, Ms, Ms, Ms, Wo
Ms, Ms, Ha, Ms, Ms, Ms, Ms, Ms, Ms, Aa^Fpa, Aa^Fpa, Aa^Fpa, Ai, Re^Qhu, Ai, Ai, Ai, Ai, Ha^Fpa, Ha^Fpa, Ha, Ai, Ai, Ms, Rra, Rra, Rra, Ms, Rra, Rra, Aa^Fpa, Rra, Aa^Fpa, Aa^Fpa, Aa^Fpa, Aa^Fpa, Aa^Fpa, Aa^Fpa, Xu, Xu, Xu, Ms, Xu, Ms, Xu, Ms, Xu, Xu
Ha, Ha, Ms, Ms, Ms, Ms, Ms, Ms, Ai, Ai, Ai, Ai, Ms, Ai^Bw|r, Ai, Ai, Aa, Aa, Rra, Ms, Rra, Aa^Fpa, Rra, Ai^Bw/r, Ai, Ms, Aa^Fpa, Rra, Ms, Ms, Ms, Rra, Rra, Aa^Fpa, Aa^Fpa, Aa^Fpa, Xu, Xu, Uh^Qhh, Uh^Qhh, Uu, Xu, Uh^Qhh, Xu, Uu, Xu, Uh^Qhh, Uu
Ai, Ms, Ms, Aa^Fpa, Ms, Ms, Ms, Ww, Ai, Ww, Ms, Ms, Ms, Re, Aa^Fpa, Aa, Rra, Rra, Ms, Rra, Ms, Rra, Ms, Ha^Vhha, Ms, Ai, Ai, Aa^Fpa, Ms, Ms, Ms, Aa^Fpa, Ms, Rra, Ur, Xu, Uu^Vu, Uh^Qhh, Uu, Uu, Uu, Uh^Qhh, Uu, Uh^Qhh, Uu, Uh^Qhh, Uh^Qhh, Uu
Ms^Xm, Ms^Xm, Ms, Ms, Ms^Xm, Ms^Xm, Aa^Fpa, Ai, Ai, Ms, Ms, Ms, Ms, Rra, Rra, Rra, Ms, Ms, Ms, Ms, Ms, Ms, Ms, Ms, Ms, Ms, Aa^Fpa, Ai, Ai, Ms, Aa^Fpa, Aa^Fpa, Aa^Fpa, Cfa, Xu, Ur, Ur, Ur, Ur, Ur, Ur, Ur, Ur, Uu^Vct, Ur, Uu, Uu, Uu
Ai, Ms, Ms, Ms^Xm, Ms, Ms, Aa^Fpa, Ai, Ai, Ms, Ms, Ms, Rra, Rra, Aa^Fpa, Ms, Ms, Ms, Ms, Ms, Ms, Ms, Ms, Ms, Ms, Ms, Aa^Fpa, Ms, Aa^Fpa, Ai, Ai, Ms, Ms, Ms, Xu, Ww^Qhu, Ai, Ww^Qhu, Uu, Uu, Cer^Vct, Cer, Cer, Ur, Cer, Ur, Ur, Uu
Ms, Ms, Ha, Ms, Aa^Feta, Ms, Aa^Fpa, Ai, Ai, Ms, Aa, Aa, Rra, Aa, Aa^Fpa, Ms, Ms^Xm, Ms, Ms^Xm, Ms, Ms, Ms, Ms, Ms, Ms, Ms, Aa^Fpa, Aa^Fpa, Ms, Ms, Aa^Fpa, Ai, Ai, Ms, Ai, Ai, Xu, Ww^Qhu, Ww^Qhu, Tb^Tf, Tb^Tf, Cer, Cer, 1 Kerg, Cer, Cer, Cer, Ur
Rra, Ha, Rra, Rra, Rra, Aa^Fpa, Aa^Fpa, Ai, Ai, Ms, Aa, Aa, Rra, Aa, Aa^Fpa, Ms, Ms, Ms^Xm, Ms, Ms, Ms^Xm, Ms, Ms, Ms, Ms, Ms, Aa^Fpa, Ms, Ms, Ms, Ai, Ai, Ai, Ai, Ha, Aa, Aa, Xu, Xu, Ss^Qhu, Xu, Tb^Tf, Xu, Uu, Uu, Uu, Uu, Uu
Ha, Rra, Ha, Ha, Ms, Rra, Rra, Ai, Ai, Ms, Ha, Aa, Rra, Aa, Aa^Fpa, Ms, Ms, Ms, Ms, Ms, Ha^Cov, Ms^Xm, Ms^Xm, Ms, Ms, Ms, Ms, Ms, Ms, Ms, Ai, Ai, Ha, Aa, Aa^Vaa, Aa, Ms, Ms, Ms, Xu, Ms^Xm, Xu, Ms, Xu, Xu, Tb^Tf, Tb^Tf, Tb^Tf
Ms, Ha, Ms, Ms, Ms, Aa^Fpa, Ha, Ai^Bw\r, Ai^Bw\r, Ms, Rra, Rra, Rra, Aa, Aa^Fpa, Ms, Ms, Ms, Ms, Ms, Ha^Cov, 2 Ms^Kov, Ha^Cov, Ms^Xm, Ms, Ms^Xm, Ms^Xm, Ms, Ms, Ms, Ww, Ai, Aa, Aa, Ha, Ha, Ms, Ms, Ms, Ms, Ms^Xm, Ms, Ms, Xu, Qxu, Qxu, Qxu^Bp|, Qxu
Ms, Ms, Ms, Ms, Ms, Ms, Ha, Ai, Ai, Rra, Rra, Aa^Fpa, Rra, Aa, Aa^Fpa, Ha, Aa^Fpa, Ms, Ms, Ms, Ms, Ha^Cov, Ha, Ha, Ha^Qhh, Ww, Ww, Ms^Xm, Ms^Xm, Ww, Ww, Ai, Ha, Ha, Aa, Aa, Ms, Ms, Ms, Ms, Ms^Xm, Ms, Xu, Xu, Tb^Tf, Tb^Tf, Tb^Tf, Qxu
Ms, Ms, Ms, Ms, Ms, Ha, Ha, Ai, Ai, Ha, Ha, Rra, Rra, Aa, Aa^Fpa, Aa^Fpa, Aa^Fpa, Aa^Fpa, Ms, Ms, Ms, Ms, Ms, Ha^Qhh, Aa^Fpa, Aa^Fpa, Ai, Ai, Ai, Ms^Xm, Ms^Xm, Ms, Ms, Ha, Ha, Aa, Ha, Ms, Ms, Ms, Ms^Xm, Xu, Xu, Ss^Qhu, Ss^Qhu, Ss^Qhu, Tb^Tf, Tb^Tf
Ms, Ms, Ms, Ms, Ms, Ms, Ms, Ai, Ai, Ms, Ha, Aa^Fpa, Rra, Aa, Aa^Fpa, Aa^Feta, Aa^Fpa, Ha, Ms, Ms, Ms, Ms, Ha, Ha^Qhh, Aa^Fpa, Aa^Fpa, Aa^Fpa, Aa^Fpa, Ms, Ms, Ms, Ms^Xm, Ms^Xm, Ha, Ms, Ha, Ms, Ms, Ms^Xm, Ms^Xm, Ms, Xu, Xu, Xu, Xu, Xu, Ur, Uu
Ms, Ms, Ms, Ms, Ms, Ms, Ms, Ai, Ai, Ms, Aa^Fpa, Aa^Fpa, Rra, Aa, Ha, Aa^Fpa, Ms, Ms, Ms, Ms, Ms, Ms, Ha, Ha^Qhh, Aa^Fpa, Aa^Fpa, Ms, Ms, Ms, Ms, Aa^Fpa, Aa^Fpa, Aa^Fpa, Ms^Xm, Ms^Xm, Ms, Ms^Xm, Ms^Xm, Ha, Ms, Ms, Xu, Xu, Uu, Ur, Ur, Uu, Uu
Ms, Ms, Ms, Ms, Ms, Ms, Ai, Ai, Ww, Ms, Aa^Fpa, Aa, Rra, Aa, Aa, Ha, Ms, Ms, Ms, Ms, Ms, Ha, Rra, Ha^Qhh, Ha, Ms, Ms, Ms, Xu, Ms, Aa^Fpa, Aa^Fpa, Aa^Fpa, Ms, Ms, Ms^Xm, Ms^Xm, Ms, Ha, Ms, Ms, Xu, Xu, Tb^Tf, Uu, Ur, Uu^Feth, Uu
Ms, Ms, Ms, Ms, Ai, Ai, Ww, Ww, Aa^Fpa, Aa^Fpa, Aa^Vla, Aa, Rra, Aa^Vha, Aa, Aa^Fpa, Ms, Ms, Ms, Ms, Rra, Rra, Ha, Rra, Rra, Ms, Xu, Xu, Uu, Xu, Xu, Aa^Fpa, Aa^Fpa, Aa^Fpa, Ms, Ms, Ms, Ms^Xm, Ms^Xm, Ms, Ms, Ms, Ms, Xu, Xu, Uu^Vu, Uu, Uu
Ms, Ms, Ai, Ai, Ai, Ai, Aa^Fpa, Aa^Fpa, Aa^Fpa, Aa^Fpa, Cea, Cea, Rrc, Rb, Rb, Aa, Ha^Vwm, Ms, Rra, Rra, Ms, Ms, Ms, Cfa, Xu, Ur^Pr/, Ur, Uu, Uh^Qhh, Uh, Cfr, Xu, Xu, Aa^Fpa, Ms, Ms, Ms, Ms, Ms, Ms^Xm, Ms, Ms, Ms, Ms, Ms, Xu, Xu, Uu
Ai, Ai, Ai, Ai, Ms, Ms, Ms, Ms, Aa, Cea, Cea, 5 Kea, Rrc, Rb^Ecf, Rb^Qhh, Ha^Qhh, Rra, Rra, Ms, Ms, Ms, Ms, Xu, Xu, Uu, Uu, Uh^Qhh, Ur, Uh^Qhh, Uu, Cfr^Qhh, Uu^Vud, Ur, Xu, Xu, Ms, Ms, Ms, Ms, Ms^Xm, Ms, Ms, Ms, Ms, Ms, Ms, Ms, Xu
Ai, Ai, Ms, Ms, Ms, Aa, Ms, Aa, Aa^Vha, Aa, Aa, Cea, Rra, Rb, Rra, Rra, Aa, Ha, Ms, Ms, Ms, Xu, Uh^Qhh, Uh^Qhh, Uu, Uu, Uu, Ur, Uu, Uu, Uu, Cfr^Qhh, Cfr^Qhh, Cfr, 6 Kfr, Xu, Ms, Ms, Ms, Ms^Xm, Ms, Ms, Ms, Ms, Ms, Ms, Ms, Ms
Ms, Ai, Ms, Ms, Ms, Ms, Ms, Ms, Ms, Aa, Rra, Rra, Ms, Rra, Ms, Aa, Ms, Ms, Ms, Ms, Ms, Xu, Uh^Qhh, Uh, Uu, Uu, Uh^Qhh, Ur, Ur, Tb^Tf, Uu, Uu, Uu, Uu, Uu, Xu, Ms, Ms, Ms, Ms^Xm, Ms^Xm, Ms, Ms, Ms, Ms, Ms, Ms, Ms
Ms, Ms, Ms, Ms, Ms, Ms, Ms, Ms, Ms, Rra, Ms, Aa^Fpa, Ms, Aa^Fpa, Aa^Fpa, Ms, Mm, Ms, Ha, Ms, Xu, Xu, Uu, Uu, Uu, Uu, Uu, Uu, Ur, Uu, Uu, Uu, Uu, Uu, Uu, Xu, Xu, Ms, Ms, Ms^Xm, Ms^Xm, Ms^Xm, Ms^Xm, Ms, Ms, Ms, Ms, Ms
