Ss, Gs^Fp, Gs^Fp, Gs^Fp, Gs^Fp, Gs^Fp, Gs^Fp, Gs^Fp, Gs^Fp, Ss, Ss, Gs^Fp, Ss, Gs^Fp, Re, Gs^Fp, Gs^Fp, Gs^Fp, Ss, Ss, Ss, Ss, Ss, Ss, Gs^Fp, Gs^Fp, Gs^Fp, Gs^Fp, Ss, Ss, Ss, Ss
Ss, Gs^Fp, Gs^Fp, Gs^Fp, Gs^Fp, Gs^Fp, Gs^Fp, Gs^Fp, Gs^Fp, Gs^Fp, Re, Re, Re, Re, Gs^Fp, Gs^Fp, Gs^Fp, Gs^Fp, Ss, Ss, Ss, Ss, Ss, Gs^Fp, Gs^Fp, Gs^Fp, Gs^Fp, Gs^Fp, Ss, Gs^Fp, Gs^Fp, Gs^Fp
Ss, Gs^Fp, Ss, Gs^Fp, Gs^Fp, Ss, Ss, Gs^Fp, Gs^Fp, Ss, Re, Ss, Ss, Gs^Fp, Gs^Fp, Sm, Gs^Fp, Gs^Fp, Ss, Ss, Sm, Sm, Ss, Gs^Fp, Ss, Ss, Gs^Fp, Ss, Ss, Ss, Gs^Fp, Gs^Fp
Ss, Ss, Ss, Hh^Cov, Hh^Cov, Hh^Cov, Ss, Ss, Re, Wwf, Re, Cte^Qhh, Re, Ss, Gs^Fp, Gs^Fp, Ww, Gs^Fp, Ss, Ss, Ss, Sm, Ss, Ss, Ss, Ss, Ss, Ss, Ss, Ss, Gs^Fp, Ss
Ss, Ss, Ss, Hh^Cov, Hhd^Kov, Hh^Cov, Ww^Bw/, Re, Gs^Fp, Re, Ss, Wwf, Ss, Re, Re, Ss, Ww, Ss, Ss, Ss, Ss, Ss, Ss, Ss, Ss, Ss, Ss, Ss, Gs^Fp, Gs^Fp, Ww, Ww
Ss, Ss, Ss, Ss, Ww^Bw/, Hh^Cov, Ss, Ss, Gs^Fp, Gs^Fp, Gs^Fp, Ss, Gs^Fp, Gs^Fp, Ss, Re, Mm, Ss, Sm^Qhh, Ss, Ss^Vhs, Cte^Qhh, Ss, Ss, Ss, Hh, Ss, Ss, Gs^Fp, Gs^Fp, Ww^Ewf, Ww
Gs^Fp, Gs^Fp, Re, Ww^Bw/, Wwf, Ss, Ss, Ss, Ss, Gs^Fp, Ss, Ss, Gs^Fp, Gs^Fp, Gs^Fp, Gs^Fp, Ss, Sm^Qhh, Sm, Sm^Bw\, Sm^Qhh, Cte^Qhh, Ss, Ss, Mm, Md, Ss, Ss, Ss, Gs^Fp, Ww, Ww
Re, Re, Wwf, Wwf, Ss, Ss, Ss, Gg, Ss, Ss, Gs, Gg, Ss, Ss, Ss, Gs^Fp, Ss, Ss, Ss, Ss, Sm^Qhh, Kte^Qhh, Hh, Hh, Mm, Md, Ss, Ss, Gg, Ww, Wo^Ewf, Wo
Ss, Ss, Ss, Ss, Ss, Ss, Ss, Gg, Gs, Gs^Efm, Gs^Efm, Gg, Ss, Ss, Ww, Ww, Ww^Ewf, Ww, Ss, Ss, Sm^Qhh, Ss, Hh, Mm, Mm, Mm, Ss, Ss, Gg^Efm, Ww, Wo, Ww
Ss, Gs^Fp, Ss, Ss, Ss, Gs^Fp, Ss, Gg, Wwf, Gs^Efm, Gg, Ss, Ww, Ww^Ewf, Wo, Wo, Wo, Wo, Ww, Ss, Sm^Qhh, Ss, Hh, Mm, Mm, Mm, Ss, Ss, Ss, Gg, Ss, Gs^Fp
Gs^Fp, Gs^Fp, Ss, Ss, Ss, Gs^Fp, Ss, Wwf, Ss, Ss, Gg, Ww, Wo, Wo, Wo, Wo, Wo, Wo, Ss, Ss^Vhs, Ww^Bw|, Ss, Hh, Mm, Mm, Mm, Mm, Hh, Ss, Gg, Ss, Ss
Sm, Ss, Ss, Ss, Ss, Ss, Ss, Ss, Ss, Ss, Ss^Vhs, Ww, Wo, Wo, Wo, Wo, Wo, Wo, Ss, Ss, Sm^Qhh, Ss, Hh, Mm, Mm, Mm, Mm, Hh, Gs, Gg, Gs, Ss
Gs^Fp, Gs^Fp, Ss, Ss, Ss, Ss, Ss, Gs^Fp, Gs^Fp, Ss, Ww, Ww^Ewl, Wo, Wo, Wo, Wo, Wo, Wo, Ss, Ss, Ss, Cte^Qhh, Sm^Qhh, Hh, Hh, Mm, Mm, Mm, Hh, Gs, Gs, Gg
Ss, Ss, Ss, Ss, Ss, Ss, Ss, Gs^Fp, Gs^Fp, Ww, Wo, Wo, Wo, Wo, Wo, Wo, Wo, Wo, Ww^Ewf, Sm, Sm, Ss, Ss, Ww^Bw\, Ww^Bw\, Ss, Hh, Mm, Hh, Hh, Gs, Gg
Hh, Ss, Ss, Ss, Ss, Ss, Ss, Gs^Fp, Gs^Fp, Ww, Wo, Wo, Wo, Wo, Ww^Ewf, Wo, Wo, Wo, Ww, Gs^Fp, Ss, Ss, Ss, Ss, Ss, Ww^Bw\, Re, Hh, Hh, Gs, Gs^Efm, Gg
Hh, Gs, Gs^Efm, Gg, Gg, Ss, Ss, Gs^Fp, Gs^Fp, Ww, Wo, Wo, Wo, Ww^Ewf, Wo, Wo, Wo, Wo, Wo, Ww, Ww, Ww, Gs^Fp, Gs^Fp, Ss, Ss, Re, Gs, Hh, Gs, Gs, Gg
Ww, Ww^Ewf, Gg, Ss, Ss, Ss, Ss, Gs^Fp, Gs^Fp, Ww^Ewl, Wo, Wo, Wo, Wo, Wo, Wo, Wo, Wo, Wo, Wo, Wo, Wo, Wo, Ww, Gs^Fp, Ss, Re, Gg^Vd, Gg, Gs^Efm, Gg, Gg
Ss, Ww, Ss, Gs^Fp, Gs^Fp, Ss, Gs^Fp, Gs^Fp, Gs^Fp, Ww, Wo, Wo, Wo, Wo, Ww, Ww, Ww, Ww, Ww, Ww, Ww^Ewl, Wo, Wo, Wo, Ww, Ss, Ss, Re, Re, Gg, Hh, Hh
Ss, Ss, Gs^Fp, Gs^Fp, Gs^Fp, Ww, Ww^Ewf, Ww, Ww, Wo, Wo, Wo, Wo, Ww, Ww, Ss, Ss, Ss, Ss, Ss, Ss, Ss, Ss, Wo, Wo, Ww, Ss, Ss, Re, Gg, Hh, Gg
Ss, Gs^Fp, Gs^Fp, Gs^Fp, Gs^Fp, Ww, Wo, Wo, Wo, Wo, Wo, Wo, Ww, Ww, Ss, Ss, Gg, Ss, Ss, Sm, Ss, Ss, Ss, Ss, Ww, Ss, Ss, Ss, Re, Gs, Gg, Gg
Gs^Fp, Gs^Fp, Gs^Fp, Gs^Fp, Gs^Fp, Ww, Ww, Wo, Ww, Ww, Ss, Gs^Fp, 3 Gg^Vd, Gs^Fp, Ss, Ss, Gs, Gs, Hh, Hh, Sm, Sm, Ss, Ss, Ss, Cte^Qhh, Cte, Cte^Qhu, Re, Gg^Efm, Gg^Efm, Gg
Gs^Fp, Gs^Fp, Gs^Fp, Gs^Fp, Gs^Fp, Gs^Fp, Ww, Wo, Ww, Ss, Ss, Gs^Fp, Gs^Fp, Gs^Fp, Ss, Hh, Hh, Mm, Mm, Hh, Ss, Sm, Ss, Ss, Ss, Cte^Qhh, 1 Kte^Vd, Cte^Qhu, Gg, Gg^Efm, Gg^Efm, Gg
Ss, Ss, Ss, Ss, Ss, Gs^Fp, Ww, Wo, Ss, Ss, Ss, Ss, Ss, Ss, Hh, Mm, Mm, Mm, Mm, Hh, Ss, Ss, Ss, Gs^Fp, Gs^Fp, Gs^Fp, Ss, Ss, Ss, Gg, Gg, Ss
Ss, Hh, Ss, Ss, Ss, Gs^Fp, Ww^Ewf, Wo, Ss, Ss, Ss, Ss, Hh, Hh, Mm, Mm, Mm, Mm, Mm, Hh, Ss, Ss, Gs^Fp, Gg^Vd, Gs^Fp, Gs^Fp, Ss, Ss, Ss, Ss, Ss, Ww
Ss, Hh, Ss, Gs^Fp, Ss, Gs^Fp, Ww, Wo, Ss, Ss, Gs, Gs, Hh, Mm, Mm, Mm, Hh, Hh, Hh, Gs, Ss, Ss, Ss, Gs^Fp, Ss, Ss, Ss, Ss, Ss, Ss, Ss, Ss
Ss, Ss, Ss, Gs^Fp, Gs^Fp, Gs^Fp, Ww, Wo, Ww, Gg, Gg^Efm, Gs^Efm, Gs, Hh, Hh, Hh, Gs, Gs, Gg^Efm, Gs^Efm, Gg, Ss, Ss, Ss, Ss, Ss, Gg, Gg, Ss, Ss, Ss, Ss
Gs^Fp, Gs^Fp, Gs^Fp, Gs^Fp, Gs^Fp, Ww, Ww, Wo, Ss, Ss, Gg, Gg, Gg, Gg, Gg, Gg, Gg, Gg^Efm, Gg, Gg, Gg, Ss, Ss, Ss, Ss, Ss, Gg, Gs, Ss, Ss, Ss, Gs^Fp
