Xue, Xue, Xue, Xue, Ww, Ww, Ww, Ww, Xue, Xue, Xue, Xue, Xue, Xue, Xue, Xue, Xue, Xue, Xue, Xue, Xue, Gg, Ww, Ww, Ww, Ww, Ww, Ww, Ww, Ww, Ww, Ss
Xue, Xue, Xue, Xue, Ss, Ww, Ww, Ss, Ss, Ss, Xue, Xue, Ss, Ss, Sm, Sm, Sm, Ss, Ss, Ss, Ss, Ss, Ww, Ww, Ww, Ww, Ww, Ss^Vhs, Ss, Ww, Ww, Xue
Xue, Xue, Xue, Xue, Xue, Ss, Ss, Ss, Ss, Ss, Xue, Ss, Ss, Ss, Sm, Cse, Sm, Ss, Ss, Xue, Xue, Xue, Ss, Ss, Ss, Ww^Ewf, Sm, Ss, Xue, Ss, Xue, Xue
Tb^Tf, Tb^Tf, Tb^Vd, Cte, Cse, Cse, Ss, Ss, Ss, Ss, Xue, Xue, Ss, Ss, Ss, Sm, Ss, Ss, Xue, Xue, Xue, Xue, Ss, Ss, Uue^Vd, Sm, Sm, Ss, Ss, Ss, Ss, Xue
Xue, Tb^Tf, Tb^Tf, Cte, 5 Kte^Vd, Cse, Ss, Ss, Ss, Xue, Xue, Xue, Tb^Tf, Ss, Ss, Ss, Ss, Ss, Xue, Xue, Xue, Ss, Ss, Ss, Uue, Uue, Uue, Ss, Ss, Ss, Ss, Xue
Xue, Xue, Ds, Cte, Cte, Cte, Ww, Ss, Ss, Xue, Xue, Xue, Xue, Tb^Tf, Ss, Ss, Ss^Vhs, Ss, Ss, Xue, Ss, Ss, Chs, Ss, Ur, Chw^Vd, Chw, Chs, Ss, Xue, Xue, Xue
Xue, Xue, Ww, Ww, Ww, Ww^Bw|, Sm, Ss, Ss, Ss, Ss, Xue, Ss, Tb^Tf, Ss, Ss, Ss, Ss, Ss, Ss, Ss^Bw/, Ss^Bw/, Xue, Chs, Uue, Chw, 4 Khs, Chs, Ss, Xue, Xue, Xue
Ww, Ww^Ewf, Ww, Ww, Ds, Ur, Ur, Xue, Xue, Ss, Ss, Ss, Ss, Ss, Ss, Ss, Ss, Ss, Chs, Ss^Bw/, Ss, Xue, Tb^Tf, Ss, Chs, Chs, Chs, Ss, Tb^Tf, Xue, Xue, Xue
Ww, Ww, Xue, Xue, Ss, Ss, Ur, Xue, Tb^Tf, Xue, Xue, Xue, Ss, Ss, Ss, Ss, Ss, Uue, Ur, Ss, Ss, Xue, Ss^Vhs, Ss, Ss, Ss, Ss, Ss, Tb^Tf, Xue, Ss, Xue
Xue, Xue, Xue, Ss, Xue, Xue, Ur, Tb^Tf, Tb^Tf, Uhe, Uue^Vd, Xue, Xue, Xue, Ss, Ss, Ss, Ss, Chs, Ss, Ss, Ss, Ss, Ss, Ss, Ss, Ss, Ss, Ss, Ss, Ss, Xue
Xue, Kse, Ss, Ss, Xue, Uhe, Xue, Ur, Ur, Ur, Ur, Ur, Ur, Xue, Xue, Xue, Xue, Ur, Ss, Ss, Ss, Ss, Ss, Ss, Uue, Uue, Ss, Ss, Ss, Ss, Uue, Xue
Xue, Ss, Ss, Ss, Xue, Xue, Ww, Ds, Ds, Ss, Ss, Xue, Xue, Ur, Ur, Ur, Ur, Ur, Tb^Tf, Xue, Xue, Ss, Ss, Ss, Tb^Tf, Uue, Uue, Ss, Ww^Ewl, Ss^Vhs, Ww, Xue
Xue, Xue, Ss, Ss, Ss^Vhs, Sm, Sm, Ww, Ww^Ewf, Ss, Ss, Ss, Xue, Uue, Ur, Xue, Uue, Xue, Tb^Tf, Xue, Xue, Xue, Ss, Uue, Uue, Uue, Ww, Ww, Ww, Ww, Ww^Ii, Ww
Xue, Xue, Xue, Ss, Ss, Ss, Sm, Ww, Ww, Ww, Sm, Ss, Ss, Ss, Ss, Cte, Xue, Xue, Tb^Tf, Ss, Ww, Xue, Ss, Ss, Ss, Ss, Ss, Ww^Ii, Ss, Ww, Ww, Ww
Xue, 6 Kse, Cse, Ss, Ss, Ss, Xue, Sm, Sm, Ww, Sm, Ss, Ss, Ss, Ss, Ss^Bw|, Tb^Tf, Tb^Tf, Xue, Xue, Ww, Ss, Ss, Gs, Gs^Ii, Gs, Ss, Ss, Uue, Uue, Uue, Xue
Xue, Cse, Xue, Uue, Uue, Uue, Ss, Ss, Ss, Sm, Ss, Ss, Uue, Uhe, Uue, Ur, Ss, Tb^Tf, Ss, Ss, Ss, Ss, Ss, Ss, Ss, Ss, Gs, Gs, Uue, Tb^Tf, Uue, Xue
Xue, Xue, Ss, Ss, Tb^Tf, Uhe, Ss, Ss, Sm, Ss, Ss, Ss, Uue, Uue^Vd, Uue, Ur, Ur, Ss, Ss, Ss, Ss, Ww, Ww^Ewf, Ww, Ss, Ss, Gs, Gs^Ii, Uue, Ss, Ss, Xue
Xue, Ss, Ss, Tb^Tf, Uue, Cte, Uue, Ww, Ww^Ewf, Sm, Ss, Ss, Ss^Vhs, Ss, Ss, Ss^Bw|r, Ss, Ww^Bw\, Ur, Ss, Ss, Ww, Ww^Ii, Ww^Ewl, Ss^Vhs, Ss, Ss, Gs, Ss, Ss, Ss^Vhs, Ss
Xue, Ds, Sm, Ss, Uue, Uue, Uue, Ww, Ww, Sm, Ss, Ss, Xue, Ss, Ss, Ss^Bw|r, Ss, Ss, Xue, Sm, Sm, Ss, Ww, Ww, Ww, Ww, Ss, Ss, Ss, Ss, Ur, Ur
Xue, Ds, Ss, Ss, Ss, Ss, Ss, Ds, Uue, Tb^Tf, Uue, Uue, Ss, Ss, Chs^Vhs, Chs, Chs, Ss, Ss, Ur, Sm, Ww, Ww, Kte, Ww, Ww^Ii, Ww, Ww, Gs^Ii, Ss, Cer, Uue
Xue, Ss, Ss, Ss, Ss, Ss, Ss, Ss, Ss, Uue, Ss, Uue, Ss, Ss, Chs, Khs, Chs, Ss^Bw\r, Ss^Bw\r, Ur, Cte, Sm, Ww, Ww, Ww^Ewl, Ww, Ss, Ss, Ss^Bw/, Ss^Bw/, Ss, Ss
Ww, Ss, Ss, Ss, Ww, Ss, Xue, Xue, Ss, Ss, Xue, Ss, Xue, Ss, Ss, Chs, Ss, Ss, Ss, Ur, Uue, Tb^Tf, Ww, Ww^Ii, Ww, Ww, Ss, Ur, Ss^Vhs, Ss, Ss, Xue
Ww, Ww^Ewl, Ww, Ww, Ww, Ww, Xue, Xue, Xue, Xue, Cfr, Xue, Cfr, Xue, Ss, Ss, Ss, Ss, Uue, Ur, Ur, Uue, Ss^Vhs, Ww, Ss^Bw/, Ur, Ur, Cer, Ss, Ss, Ss, Xue
Xue, Ww, Sm, Ww^Ewl, Sm, Sm, Ss, Xue, Xue, Xue, Cfr, Kfr, Cfr, Xue, Xue, Ss, Tb^Tf, Tb^Tf, Uue, Uue, Uue^Vd, Ur, Ss^Bw/, Ss^Bw/, Xue, Xue, Ss, Ss, Ss, Xue, Xue, Xue
Xue, Xue, Ss, Sm, Ss, Ss, Ss, Xue, Xue, Uhe, Uhe, Xue, Uue, Uue, Xue, Ss, Uue, Uue, Uhe, Uue, Ur, Ur, Ss, Ss, Ss, Ss, Ss, Ss, Ss, Xue, Xue, Xue
Xue, Ss, Ss, Ss, Ss^Vhs, Ss, Ss, Ss, Ss, Uue, Xue, Xue, Xue, Uue, Ss, Ss, Ss, Uue, Uhe, Uue, Ur, Xue, Ss, Ss, Ss, Ss, Ss, Ss, Ss, Ss, Ss, Xue
Xue, Ss, Ss, Ss, Ss, Ss, Ss, Ss, Ss, Uue, Ss, Ss, Xue, Xue, Tb^Tf, Ss, Ss, Uue, Uue, Xue, Ur, Xue, Xue, Tb^Tf, Ss, Ss, Ss, Xue, Xue, Ss, Ss, Xue
Xue, Ss, Ss, Xue, Xue, Ss, Ss, Ss, Ss, Uue, Ss, Ss, Ss, Ss, Tb^Tf, Ss, Ss, Ss, Ss, Ss, Ur, Xue, Xue, Xue, Ss, Ss, Tb^Tf, Ss, Xue, Ss, Xue, Xue
Xue, Ss, Xue, Xue, Uue, Xue, Ss, Ss, Ss, Uue, Uue^Vd, Tb^Tf, Ss, Ss, Sm, Tb^Tf, Ss, Ss, Ss, Ss, Ss^Vhs, Ur, Xue, Xue, Ss, Xue, Ss, Ss, Ss, Sm, Sm, Xue
Xue, Ss, Xue, Xue, Xue, Uue, Ss, Ss, Ss, Ss, Ww, Ds, Ds, Ss, Xue, Tb^Tf, Xue, Ss, Ss, Xue, Xue, Ur, Xue, Xue, Ss, Ss, Ss, Ss, Xue, Xue, Cse, Xue
Xue, Ss, Ss, Ss, Uue, Uue, Sm, Ss, Ss, Ww, Ww, Ww, Ww, Uhe, Xue, Tb^Tf, Xue, Xue, Xue, Xue, Ur, Ss^Bw|, Ss, Uue, Ss, Ss, Xue, Xue, Xue, Xue, Xue, Xue
Uhe, Uhe, Uhe, Ss, Ss, Xue, Xue, Sm, Sm, Ss, Ss, Ww, Ds, Uhe, Ur, Ur, Ur, Xue, Ur, Ss^Bw/, Ss, Cte, Ur, Uue, Ss, Ss, Ss, Xue, Xue, Xue, Xue, Xue
Uhe, Xue, Uhe, Ss, Xue, Xue, Xue, Xue, Xue, Ss, Ss, Ss, Uue^Vd, Ur, Xue, Xue, Xue, Ur, Uue^Vd, Ss, Ss, Ss, Ur, Uue, Ss^Vhs, Ss, Xue, Xue, Xue, Xue, Xue, Xue
Re, Uhe^Vd, Uhe, Ss, Xue, Xue, Xue, Xue, Xue, Ss, Ss, Ss, Ur, Ur, Xue, Xue, Xue, Uue, Uue, Ss, Ss, Ss, Uue, Ur, Ur, Ss, Xue, Xue, Xue, Xue, Xue, Xue
Ss, Cer, Ss, Ss, Ss, Xue, Xue, Uue, Ss, Ss, Ss, Ss, Ur, Uue, Uhe, Xue, Xue, Uue, Uue, Ss, Ss, Ss, Ss, Uue, Uue^Vd, Ss^Bw\, Cer^Vct, Xue, Xue, Xue, Xue, Xue
Ss, Ww^Bw|, Ss, Cer^Vct, Cer, Cer, Ur, Ur, Ur, Ur, Ur, Ur, Uue, Xue, Xue, Uhe, Uue, Sm, Sm, Sm, Ss, Ss, Uue^Vd, Uue, Uue, Cer, Cer, Cer^Vct, Xue, Qlf, Qlf, Xue
Uue, Ur, Ur, Cer, 1 Kerg, Cer, Uue, Uue^Vd, Uue, Uue, Uue^Vd, Ur, Ss, Xue, Xue, Xue, Sm, Sm, Ww, Ww, Ww, Ss, Ss, Ss, Sm, Cer, 2 Kerg, Cer, Ur, Qlf, Qlf, Qlf
Ur, Ur, Cer^Vct, Cer, Cer, Uue, Uue, Uue, Uue, Uue, Uue, Ur, Ss, Cse, Xue, Xue, Ss, Ww, Ww, Ww, Ww, Ss, Ss, Sm, Cer^Vct, Cer, Cer, Ss, Xue, Ur, Ur, Qlf
Ur, Uhe, Uue, Uue, Ss, Ss, Uue, Uue, Uue, Uue, Uue, Ur, Ss, Ss, Ss, Xue, Ss, Ss, Ss, Ss, Xue, Xue, Xue, Sm, Sm, Ss, Ss, Ss, Xue, Qlf, Qlf, Ur
Xue, Xue, Xue, Uue, Cer, Ss, Ss, Ss, Ss, Ss, Ur, Ur, Ss, Ss, Ss, Ss, Ss, Ss, Ss, Ss, Xue, Ss, Ss, Ss, Ss, Ss, Ss, Ss, Ss, Xue, Qlf, Qlf
Xue, Xue, Xue, Cer^Vct, Cer^Vct, 3 Kerg, Ss, Ss, Ss, Ss, Ss^Bw|, Ss, Ss, Ss, Xue, Ss, Ss^Vhs, Ss, Ss, Ss, Ss, Ss, Xue, Xue, Xue, Xue, Ss, Ss, Ss, Xue, Xue, Qlf
Xue, Xue, Xue, Xue, Xue, Xue, Xue, Ss, Ss, Ss, Ss, Ss, Ss, Xue, Xue, Ss, Ss, Ss, Ss, Ss, Ss, Xue, Xue, Xue, Xue, Xue, Xue, Xue, Xue, Xue, Xue, Xue
