Xue, Xue, Xue, Xue, Ww, Ww, Ww, Ww, Xue, Xue, Xue, Xue, Xue, Xue, Xue, Xue, Xue, Xue, Xue, Xue, Xue, Gg, Ww, Ww, Ww, Ww, Ww, Ww, Ww, Ww, Ww, Ss
Xue, Xue, Xue, Xue, Ss, Ww, Ww, Ss, Ss, Sm^Qhh, Xue, Xue, Ss, Ss, Sm^Qhu, Sm^Qhu, Sm^Qhu, Ss, Ss, Ss, Ss, Ss, Ww, Ww, Ww, Ww, Ww, Ss^Vhs, Ss, Ww, Ww, Xue
Xue, Xue, Xue, Xue, Xue, Ss, Ss, Ss, Ss, Sm^Qhh, Xue, Ss, Ss, Ss, Sm^Qhu, Cse, Sm^Qhu, Ss, Ss, Xue, Xue, Xue, Ss, Ss, Ss, Ww^Ewf, Sm, Ss, Xue, Ss, Xue, Xue
Tb^Qhu, Tb^Qhu, Tb^Vd, Cer, Cse, Cse, Ss, Ss, Ss, Sm^Qhh, Xue, Xue, Ss, Ss, Ss, Sm^Qhu, Ss, Ss, Xue, Xue, Xue, Xue, Ss, Ss, Uue^Vd, Sm, Sm, Ss, Ss, Ss, Sm^Qhh, Xue
Xue, Tb^Vd, Tb^Qhu, Cer, 5 Kte, Cse, Ss, Ss, Ss, Xue, Xue, Xue, Tb^Tf, Ss, Ss, Ss, Sm^Qhh, Ss, Xue, Xue, Xue, Ss, Ss, Ss, Uue^Qhh, Uue^Qhh, Uue^Qhh, Ss, Ss, Ss, Sm^Qhh, Xue
Xue, Xue, Ds, Cer, Cer, Cer, Ww, Ss, Ss, Xue, Xue, Xue, Xue, Tb^Tf, Ss, Sm^Qhh, Ss^Vhs, Ss, Ss, Xue, Ss, Ss, Cer, Ss, Ur^Qhh, Cer^Vd, Cer, Cse, Ss, Xue, Xue, Xue
Xue, Xue, Ww, Ww, Ww, Ww^Bw|, Sm, Ss, Ss, Ss, Ss, Xue, Ss, Tb^Tf, Ss, Sm^Qhh, Ss, Ss, Ss, Ss, Ss^Bw/, Ss^Bw/, Xue, Cer, Uue^Qhh, Cer, 4 Kse, Cse, Ss, Xue, Xue, Xue
Ww, Ww^Ewf, Ww, Ww, Ds, Ur, Ur, Xue, Xue, Ss, Ss, Ss, Ss, Ss, Ss, Ss, Ss, Ss, Cer^Qhh, Ss^Bw/, Ss, Xue, Tb^Tf, Ss, Cer, Cse, Cse, Ss, Tb^Tf, Xue, Xue, Xue
Ww, Ww, Xue, Xue, Ss, Ss, Ur, Xue, Tb^Tf, Xue, Xue, Xue, Sm^Qhh, Ss, Ss, Ss, Ss, Uue^Qhh, Ur^Qhh, Ss, Ss, Xue, Ss^Vhs, Ss, Ss, Ss, Ss, Ss, Tb^Tf, Xue, Ss^Qhu, Xue
Xue, Xue, Xue, Ss, Xue, Xue, Ur, Tb^Tf, Tb^Tf, Uhe, Uue^Vd, Xue, Xue, Xue, Sm^Qhh, Ss, Ss, Ss, Cer^Qhh, Ss, Ss, Ss, Ss, Ss, Ss, Ss, Ss, Ss, Ss^Qhu, Ss^Qhu, Ss^Qhu, Xue
Xue, Kse, Ss, Ss, Xue, Uhe^Qhh, Xue, Ur, Ur, Ur, Ur, Ur, Ur, Xue, Xue, Xue, Xue, Ur, Ss, Ss, Ss, Ss, Ss, Ss, Uue, Uue, Ss, Ss, Ss, Ss, Uue, Xue
Xue, Ss, Ss, Ss, Xue, Xue, Ww, Ds, Ds, Ss, Ss, Xue, Xue, Ur, Ur, Ur, Ur, Ur, Tb^Tf, Xue, Xue, Ss, Ss, Ss, Tb^Tf, Uue, Uue^Qhh, Ss, Ww^Ewl, Ss^Vhs, Ww, Xue
Xue, Xue, Ss, Ss, Ss^Vhs, Sm, Sm, Ww, Ww^Ewf, Ss, Ss, Ss, Xue, Uue^Qhh, Ur, Xue, Uue^Qhh, Xue, Tb^Qhu, Xue, Xue, Xue, Ss, Uue^Qhh, Uue^Qhh, Uue^Qhh, Ww, Ww, Ww, Ww, Ww^Ii, Ww
Xue, Xue, Xue, Ss, Ss, Ss, Sm, Ww, Ww, Ww, Sm, Ss, Ss, Ss, Ss, Cte^Qhh, Xue, Xue, Tb^Qhu, Ss^Qhu, Ww, Xue, Ss, Ss, Ss, Ss, Ss, Ww^Ii, Ss, Ww, Ww, Ww
Xue, 6 Kse, Cse, Ss, Ss, Ss, Xue, Sm, Sm, Ww, Sm, Ss, Ss, Ss, Ss, Ss^Bw|, Tb^Tf, Tb^Tf, Xue, Xue, Ww, Ss, Ss, Gs, Gs^Ii, Gs, Ss, Ss, Uue^Qhh, Uue^Qhh, Uue^Qhh, Xue
Xue, Cer, Xue, Uue, Uue, Uue, Ss, Ss, Ss, Sm, Ss, Ss, Uue^Qhh, Uhe^Qhh, Uue^Qhh, Ur, Ss, Tb^Tf, Ss, Ss, Ss, Ss, Ss, Ss, Ss, Ss, Gs, Gs, Uue^Qhu, Tb^Tf, Uue^Qhu, Xue
Xue, Xue, Ss, Ss, Tb^Tf, Uhe, Ss, Ss, Sm, Ss, Ss, Ss, Uue^Qhh, Uue^Vd, Uue^Qhh, Ur, Ur, Ss, Ss, Ss, Ss, Ww, Ww^Ewf, Ww, Ss, Ss, Gs, Gs^Ii, Uue^Qhu, Ss^Qhu, Ss^Qhu, Xue
Xue, Ss, Ss, Tb^Tf, Uue^Qhh, Cte^Qhh, Uue^Qhh, Ww, Ww^Ewf, Sm, Ss, Ss, Ss^Vhs, Ss, Ss, Ss^Bw|r, Ss, Ww^Bw\, Ur, Ss, Ss, Ww, Ww^Ii, Ww^Ewl, Ss^Vhs, Ss, Ss, Gs, Ss, Ss^Qhu, Ss^Vhs, Ss
Xue, Ds, Sm^Qhu, Ss, Uue, Uue, Uue, Ww, Ww, Sm, Ss, Ss, Xue, Ss, Ss, Ss^Bw|r, Ss, Ss, Xue, Sm, Sm, Ss, Ww, Ww, Ww, Ww, Ss, Ss, Ss, Ss, Ur^Qhh, Ur^Qhh
Xue, Ds, Ss, Ss, Ss, Ss, Ss, Ds, Uue, Tb^Tf, Uue, Uue^Qhh, Ss, Ss, Cse^Vhs, Cer, Cer, Ss, Ss, Ur, Sm, Ww, Ww, Kte, Ww, Ww^Ii, Ww, Ww, Gs^Ii, Ss, Cer^Qhh, Uue^Qhh
Xue, Ss, Ss, Ss, Ss, Ss, Ss, Ss, Ss, Uue, Ss, Uue^Qhh, Ss, Ss, Cse, Kse, Cer, Ss^Bw\r, Ss^Bw\r, Ur, Cte, Sm, Ww, Ww, Ww^Ewl, Ww, Ss, Ss, Ss^Bw/, Ss^Bw/, Ss, Ss
Ww, Ss, Ss, Ss, Ww, Ss, Xue, Xue, Ss, Ss, Xue, Ss, Xue, Ss, Ss, Cse, Ss, Ss, Ss, Ur, Uue^Qhh, Tb^Tf, Ww, Ww^Ii, Ww, Ww, Ss, Ur^Qhh, Ss^Vhs, Ss, Ss, Xue
Ww, Ww^Ewl, Ww, Ww, Ww, Ww, Xue, Xue, Xue, Xue, Cfr, Xue, Cfr, Xue, Ss, Ss, Ss, Ss, Uue, Ur, Ur, Uue^Qhh, Ss^Vhs, Ww, Ss^Bw/, Ur^Qhh, Ur^Qhh, Cer^Qhh, Ss, Ss, Ss, Xue
Xue, Ww, Sm^Qhu, Ww^Ewl, Sm, Sm, Ss, Xue, Xue, Xue, Cfr, Kfr, Cfr, Xue, Xue, Ss, Tb^Tf, Tb^Tf, Uue, Uue, Uue^Vd, Ur, Ss^Bw/, Ss^Bw/, Xue, Xue, Ss, Ss, Ss, Xue, Xue, Xue
Xue, Xue, Ss, Sm^Qhu, Ss, Ss, Ss, Xue, Xue, Uhe^Qhu, Uhe^Qhu, Xue, Uue^Qhu, Uue^Qhu, Xue, Ss, Uue, Uue, Uhe^Qhh, Uue^Qhh, Ur, Ur, Ss, Ss, Ss, Ss, Ss, Ss, Ss, Xue, Xue, Xue
Xue, Ss, Ss, Ss, Ss^Vhs, Ss, Ss, Ss, Ss, Uue, Xue, Xue, Xue, Uue, Ss, Ss, Ss, Uue^Qhh, Uhe^Qhh, Uue^Qhh, Ur, Xue, Ss, Ss, Ss, Ss, Ss, Ss, Ss, Ss, Ss, Xue
Xue, Ss, Ss, Ss, Ss, Ss, Ss, Ss, Ss, Uue, Ss, Ss, Xue, Xue, Tb^Tf, Ss, Ss, Uue^Qhh, Uue^Qhh, Xue, Ur, Xue, Xue, Tb^Tf, Ss, Ss, Ss, Xue, Xue, Ss, Ss, Xue
Xue, Ss, Ss, Xue, Xue, Ss, Ss, Ss, Ss, Uue, Ss, Ss, Ss, Ss, Tb^Tf, Ss, Ss, Ss, Ss, Ss, Ur, Xue, Xue, Xue, Ss, Ss, Tb^Tf, Ss, Xue, Ss, Xue, Xue
Xue, Ss, Xue, Xue, Uue, Xue, Ss, Ss, Ss, Uue, Uue^Vd, Tb^Tf, Ss, Ss, Sm, Tb^Tf, Ss, Ss, Ss, Ss, Ss^Vhs, Ur, Xue, Xue, Ss, Xue, Ss, Ss, Ss, Sm, Sm, Xue
Xue, Ss, Xue, Xue, Xue, Uue, Ss, Ss, Ss, Ss, Ww, Ds, Ds, Ss, Xue, Tb^Tf, Xue, Ss, Ss, Xue, Xue, Ur, Xue, Xue, Ss, Ss, Ss, Ss, Xue, Xue, Cse, Xue
Xue, Ss, Ss, Ss, Uue, Uue, Sm^Qhu, Ss, Ss, Ww, Ww, Ww, Ww, Uhe, Xue, Tb^Tf, Xue, Xue, Xue, Xue, Ur, Ss^Bw|, Ss, Uue, Ss, Ss, Xue, Xue, Xue, Xue, Xue, Xue
Uhe, Uhe^Qhh, Uhe^Qhh, Ss, Ss, Xue, Xue, Sm^Qhu, Sm^Qhu, Ss, Ss, Ww, Ds, Uhe, Ur, Ur, Ur, Xue, Ur, Ss^Bw/, Ss, Cte, Ur, Uue, Ss, Ss, Ss, Xue, Xue, Xue, Xue, Xue
Uhe, Xue, Uhe^Qhh, Ss, Xue, Xue, Xue, Xue, Xue, Ss, Ss, Ss, Uue^Vd, Ur, Xue, Xue, Xue, Ur, Uue^Vd, Ss, Ss, Ss, Ur, Uue, Ss^Vhs, Ss, Xue, Xue, Xue, Xue, Xue, Xue
Re, Uhe^Vd, Uhe^Qhh, Ss, Xue, Xue, Xue, Xue, Xue, Ss, Ss, Ss, Ur, Ur, Xue, Xue, Xue, Uue, Uue, Ss, Ss, Ss, Uue, Ur, Ur, Ss, Xue, Xue, Xue, Xue, Xue, Xue
Ss, Cer, Ss, Ss, Ss, Xue, Xue, Uue, Ss, Ss, Ss, Ss, Ur, Uue, Uhe, Xue, Xue, Uue^Qhu, Uue^Qhu, Ss, Ss, Ss, Ss, Uue, Uue^Vd, Ss^Bw\, Cer^Vct, Xue, Xue, Xue, Xue, Xue
Ss, Ww^Bw|, Ss, Cer^Vct, Cer, Cer, Ur, Ur, Ur, Ur, Ur, Ur, Uue, Xue, Xue, Uhe^Qhu, Uue^Qhu, Sm^Qhh, Sm, Sm, Ss, Ss, Uue^Vd, Uue, Uue, Cer, Cer, Cer^Vct, Xue, Qlf, Qlf, Xue
Uue, Ur, Ur, Cer, 1 Kerg, Cer, Uue, Uue^Vd, Uue^Qhu, Uue, Uue^Vd, Ur, Ss, Xue, Xue, Xue, Sm, Sm, Ww, Ww, Ww, Ss, Ss, Ss, Sm^Qhu, Cer, 2 Kerg, Cer, Ur, Qlf, Qlf, Qlf
Ur^Qhu, Ur^Qhu, Cer^Vct, Cer, Cer, Uue, Uue, Uue^Qhu, Uue^Qhh, Uue^Qhu, Uue, Ur, Ss, Cse, Xue, Xue, Ss, Ww, Ww, Ww, Ww, Ss, Ss, Sm^Qhu, Cer^Vct, Cer, Cer, Ss, Xue, Ur, Ur, Qlf
Ur^Qhu, Uhe, Uue^Qhu, Uue^Qhu, Ss, Ss, Uue, Uue, Uue, Uue^Qhu, Uue, Ur, Ss, Ss, Ss, Xue, Ss, Ss, Ss, Ss, Xue, Xue, Xue, Sm^Qhu, Sm^Qhu, Ss, Ss, Ss, Xue, Qlf, Qlf, Ur
Xue, Xue, Xue, Uue, Cer, Ss, Ss, Ss, Ss, Ss, Ur, Ur, Ss, Ss, Ss, Ss, Ss, Ss, Ss, Ss, Xue, Ss, Ss, Ss, Ss, Ss, Ss, Ss, Ss, Xue, Qlf, Qlf
Xue, Xue, Xue, Cer^Vct, Cer^Vct, 3 Kerg, Ss, Ss, Ss, Ss, Ss^Bw|, Ss, Ss, Ss, Xue, Ss, Ss^Vhs, Ss, Ss, Ss, Ss, Ss, Xue, Xue, Xue, Xue, Ss, Ss, Ss, Xue, Xue, Qlf
Xue, Xue, Xue, Xue, Xue, Xue, Xue, Ss, Ss, Ss, Ss, Ss, Ss, Xue, Xue, Ss, Ss, Ss, Ss, Ss, Ss, Xue, Xue, Xue, Xue, Xue, Xue, Xue, Xue, Xue, Xue, Xue
