Xue, Xue, Xue, Xue, Ww, Ww, Ww, Ww, Xue, Xue, Xue, Xue, Xue, Xue, Xue, Xue, Xue, Xue, Xue, Xue, Xue, Gg, Ww, Ww, Ww, Ww, Ww, Ww, Ww, Ww, Ww, Ss
Xue, Xue, Xue, Xue, Ss, Ww, Ww, Ss, Ss, Ss, Xue, Xue, Ss, Ss, Sm, Sm, Sm, Ss, Ss, Ss, Ss, Ss, Ww, Ww, Ww, Ww, Ww, Ss, Ss, Ww, Ww, Xue
Xue, Xue, Xue, Xue, Xue, Ss, Ss, Ss, Ss, Ss, Xue, Ss, Ss, Ss, Sm, Tb^Tf, Sm, Ss, Ss, Xue, Xue, Xue, Ss, Ss, Ss, Ww^Ewf, Sm, Ss, Xue, Ss, Xue, Xue
Tb^Tf, Tb^Tf, Uue^Vd, Cte, Cte, Cte, Ss^Bw/, Ss^Vhs, Ss, Ss, Xue, Xue, Ss, Ss, Ss, Sm, Ss, Ss, Xue, Xue, Xue, Xue, Ss, Ss, Uue^Vd, Sm, Sm, Ss, Tb^Tf, Tb^Tf, Tb^Tf, Xue
Xue, Tb^Tf, Tb^Tf, Cte, 1 Kte^Vd, Cte, Ss, Ss, Ss, Xue, Xue, Xue, Tb^Tf, Ss, Ss, Ss, Ss, Ss, Xue, Xue, Xue, Ss, Ss, Ss, Uue, Uue, Uue, Ss^Vhs, Uhe, Uhe, Uhe, Xue
Xue, Xue, Ds, Cte, Cte, Cte^Br\, Sm, Ss, Ss, Xue, Xue, Xue, Xue, Tb^Tf, Ss, Ss, Ss^Vhs, Ss, Ss, Xue, Ss, Ss, Ur^Br/, Ss, Co, Co^Vd, Uue^Br/, Uue^Br\, Uue^Vd, Xue, Xue, Xue
Xue, Xue, Ww, Ww, Ww, Ur^Br|, Sm, Ss, Ss, Ss, Ss, Xue, Ss, Tb^Tf, Ss, Ss, Ss, Ss^Bw\, Ss^Bw\, Ss, Ur^Br/, Ur^Br/, Xue, Co^Br\, Co^Br\, Co^Br/, 2 Ko, Co, Uue^Br|, Qlf, Qlf, Qlf
Ww, Ww^Ewf, Ww, Ww^Vhs, Ds, Ur^Br|, Ur^Br\, Xue, Xue, Ss, Ss, Ss, Ss, Ss, Ss, Ss, Ss, Ss, Ur^Br/, Ur^Br/, Ss, Xue, Tb^Tf, Ss, Co, Co^Br\, Co^Br/, Uue^Br/, Uue^Br|, Qlf, Qlf, Qlf
Ww, Ww, Xue, Xue, Ss, Ss, Ur^Br|, Xue, Tb^Tf, Xue, Xue, Xue, Ss, Ss, Ss, Ss, Ss, Co, Ur^Br|, Ss, Ss, Xue, Ss^Vhs, Ss, Ss, Ss, Tb^Tf, Tb^Tf, Uhe^Vd, Xue, Uhe^Br/, Uue^Br/
Xue, Xue, Xue, Ss, Xue, Xue, Ur^Br\, Tb^Tf, Tb^Tf, Uhe, Uue^Vd, Xue, Xue, Xue, Ss, Ss, Ss, Ss, Ur^Br|, Ss, Ss, Ss, Ss, Ss, Ss, Ss, Ss, Tb^Tf, Ss, Uhe^Br\, Ss, Xue
Xue, Tb^Tf, Ss, Ss, Xue, Uhe^Vd, Xue, Ur^Br\, Ur^Br\, Ur^Br/, Ur^Br\, Ur^Br/, Ur^Br\, Xue, Xue, Xue, Xue, Ur^Br/, Ss, Ss, Ss, Ss, Ss, Ss, Uue, Uue, Ss, Ss, Ss, Ss, Uue, Xue
Xue, Tb^Tf, Ss, Ss, Xue, Xue, Ww^Bw/, Ds^Bw/, Ds, Ss, Ss, Xue, Xue, Ur^Br\, Ur^Br\, Ur, Ur^Br/, Ur^Br|, Ur^Br\, Xue, Xue, Ss, Ss, Ss, Tb^Tf, Uue, Uue, Ss, Ww^Ewf, Ss^Vhs, Ww, Xue
Xue, Xue, Ss, Ss, Ss^Vhs, Sm^Bw/, Sm, Ww, Ww^Ewf, Ss, Ss, Ss, Xue, Uue, Ur, Ur^Br\, Tb^Tf, Xue, Tb^Tf, Ur^Br\, Ur^Br\, Xue, Ss, Uue, Uue, Uue, Ww, Ww, Ww, Ww, Ww^Ii, Ww
Xue, Xue, Xue, Ss, Ss, Ss, Sm, Ww, Ww, Ww, Sm, Ss, Ss, Ss, Ss, Cte, Xue, Xue, Tb^Tf, Tb^Tf, Ww, Ur^Br\, Ur^Br\, Ss, Ss, Ss, Ss, Ww^Ii, Ww, Ww, Ww, Ww
Xue, Uhe, Uue, Ss, Ss, Ss, Xue, Sm, Sm, Ww, Sm, Ss, Tb^Tf, Ss, Ss, Ss^Bw|, Tb^Tf, Tb^Tf, Xue, Xue, Ww, Ss, Ss, Ur^Br\, Ur^Br\, Ss, Ww, Ww, Tb^Tf, Gs^Vd, Gs, Xue
Xue, Tb^Tf, Xue, Uue, Uue, Uue, Ss, Ss, Ss, Sm, Ss, Tb^Tf, Uue, Uhe, Uue, Ur, Ss, Tb^Tf, Ss, Ss, Ss, Ww, Ww, Ss, Ww, Ur^Br\, Ch^Br\, Ch^Ii, Ch, Tb^Tf, Gs^Vd, Xue
Xue, Xue, Ss, Ss, Tb^Tf, Uhe, Ss, Ss, Sm, Ss, Ss, Tb^Tf, Uue, Uue^Vd, Ur, Ur, Ur, Ss, Ss, Ss, Ss, Ww, Ww^Ewf, Ww^Ii, Gg, Gg, Ch^Ii, 3 Kh, Ch^Ii, Tb^Tf, Gs, Xue
Xue, Ss, Ss, Tb^Tf, Uue, Cte, Uue, Ww, Ww^Ewf, Sm, Ss, Ss, Ss^Vhs, Ss^Bw/, Cte, Kte, Cte, Ss^Bw\, Ur, Ss, Sm, Ww, Sm^Ii, Sm, Rp, Rp, Gs, Ch, Rp, Tb^Tf, Gs^Vd, Gs
Xue, Ds, Sm, Ss, Uue, Uue, Uue, Ww, Ww, Sm, Ss, Ss, Xue, Ss, Ss, Cte, Cte, Cte, Ur, Sm, Sm, Sm, Gg^Ftp, Gg^Ftp, Gs^Ftp, Gs, Gg, Gg, Ch, Rp, Ur, Ur
Xue, Ds, Ss, Ss, Ss, Ss, Ss, Ds, Uue, Tb^Tf, Uue, Uue, Ss, Ss, Ss, Ss, Ss, Ss, Ss, Ur, Sm, Sm^Ii, Gg^Ftp, Hh^Feth, Gg^Ftp, Sm, Ww, Ww^Ewf, Ss^Ii, Ss, Ur, Ww
Xue, Ss, Ss, Ss, Ss, Ss, Ss, Ss, Ss, Uue, Ss, Uue, Ss, Ss, Tb^Tf, Ss, Ss, Ss, Ss, Ur, Ch, Sm^Bw/, Sm^Ii, Gg^Ftp, Sm, Sm^Ii, Ww, Ss, Ss^Bw/, Ss^Bw/, Ss, Ss
Ww, Ss, Ss, Ss, Ww, Ss, Xue, Xue, Ss, Ss, Xue, Ss, Xue, Tb^Tf, Tb^Tf, Tb^Tf, Ss, Ss, Ss, Ur, Uue, Tb^Tf, Ww, Sm, Ww^Ewf, Ww, Ww^Bw/, Ur, Ss^Vhs, Ss, Ss, Xue
Ww, Ww^Ewl, Ww, Ww, Ww, Ww, Xue, Xue, Xue, Xue, Qlf, Xue, Qlf, Xue, Ss, Ss, Ss, Ss, Uue, Ur, Ur, Uue, Ss^Vhs, Ww, Ss^Bw/, Ur, Ww, Ww, Ss, Ss, Ss, Xue
Xue, Ww, Sm, Ww^Ewl, Sm, Sm, Ss, Xue, Xue, Xue, Qlf, Mv, Qlf, Xue, Xue, Ss, Tb^Tf, Tb^Tf, Uue, Uue, Uue^Vd, Ur, Ss^Bw/, Ss^Bw/, Xue, Xue, Ss, Ss, Ss, Xue, Xue, Xue
Xue, Xue, Ss, Sm, Ss, Ss, Ss, Xue, Xue, Uhe, Uhe, Xue, Uue, Uue, Xue, Ss, Uue, Uue, Uhe, Uue, Ur, Ur, Ss, Ss, Ss, Ss, Ss, Ss, Ss, Xue, Xue, Xue
Xue, Ss, Ss, Ss, Ss^Vhs, Ss, Ss, Ss, Ss, Uue^Pr\, Xue, Xue, Xue, Uue^Pr/, Ss, Ss, Ss, Uue, Uhe, Uue, Ur, Xue, Ss, Ss, Ss, Ss, Ss, Ss, Ss, Ss, Ss, Xue
Xue, Ss, Ss, Ss, Ss, Ss, Ss, Ss, Ss, Uue, Ss, Ss, Xue, Xue, Tb^Tf, Ss, Ss, Uue, Uue, Xue, Ur, Xue, Xue, Tb^Tf, Ss, Ss, Ss, Xue, Xue, Ss, Ss, Xue
Xue, Ss, Ss, Xue, Xue, Ss, Ss, Ss, Ss, Uue, Ss, Ss, Ss, Ss, Tb^Tf, Ss, Ss, Ss, Ss, Ss, Ur, Xue, Xue, Xue, Ss, Ss, Tb^Tf, Ss, Xue, Ss, Xue, Xue
Xue, Ss, Xue, Xue, Uue, Xue, Ss, Ss, Ss, Uue, Uue^Vd, Tb^Tf, Ss, Ss, Sm, Tb^Tf, Ss, Ss, Ss, Ss, Ss^Vhs, Ur, Xue, Xue, Ss, Xue, Ss, Ss, Ss, Sm, Sm, Xue
Xue, Ss, Xue, Xue, Xue, Uue, Ss, Ss, Ss, Ss, Ww, Ds, Ds, Ss, Xue, Tb^Tf, Xue, Ss, Ss, Xue, Xue, Ur, Xue, Xue, Ss, Ss, Ss, Ss, Xue, Xue, Tb^Tf, Xue
Xue, Ss, Ss, Ss, Uue, Uue, Ss, Ss, Ss, Ww, Ww^Ewl, Ww, Ww, Uhe, Xue, Tb^Tf, Xue, Xue, Xue, Xue, Ur, Ss^Bw|, Ss, Uue, Ss, Ss, Xue, Xue, Xue, Xue, Xue, Xue
Uhe, Uhe, Uhe, Ss, Ss, Xue, Xue, Ss, Ss, Ss, Ss, Ww, Ds, Uhe, Ur, Ur, Ur, Xue, Ur, Ss^Bw/, Ss, Cte, Ur, Uue, Ss, Ss, Ss, Xue, Xue, Xue, Xue, Xue
Uhe, Xue, Uhe, Ss, Xue, Xue, Xue, Xue, Xue, Ss, Ss, Ss, Uue^Vd, Ur, Xue, Xue, Xue, Ur, Uue^Vd, Ss, Ss, Ss, Ur, Uue, Ss^Vhs, Ss, Xue, Xue, Xue, Xue, Xue, Xue
Uue, Uhe^Vd, Uhe, Ss, Xue, Xue, Xue, Xue, Xue, Ss, Ss, Ss, Ur, Ur, Xue, Xue, Xue, Uue, Uue, Ss, Ss, Ss, Uue, Ur, Ur, Ss, Xue, Xue, Xue, Xue, Xue, Xue
Ss, Uue, Ss, Ss, Ss, Xue, Xue, Uue, Ss, Ss, Ss, Ss, Ur, Uue, Uhe, Xue, Xue, Uue, Uue, Ss, Ss, Ss, Ss, Uue, Uue^Vd, Ss^Bw\, Ur, Xue, Xue, Xue, Xue, Xue
Ss, Ww^Bw|, Ss, Tb^Tf, Ur, Tb^Tf, Ur, Ur, Ur, Ur, Ur, Ur, Uue, Xue, Xue, Uhe, Uue, Sm, Sm, Sm, Ss, Ss, Uue^Vd, Uue, Uue, Uue, Uue, Ur, Xue, Qlf, Qlf, Xue
Uue, Ur, Ur, Ur, 5 Uue, Ur, Uue, Uue^Vd, Uue, Uue, Uue^Vd, Ur, Ss, Xue, Xue, Xue, Sm, Sm, Ww, Ww, Ww, Ss, Ss, Ss, Sm, Uue, 4 Uue, Ur, Ur, Qlf, Qlf, Qlf
Ur, Ur, Uue, Uue, Uue, Uue, Uue, Uue, Uue, Uue, Uue, Ur, Ss, Tb^Tf, Xue, Xue, Ss, Ww, Ww, Ww^Ewl, Ww, Ss, Ss, Sm, Tb^Tf, Tb^Tf, Tb^Tf, Ss, Xue, Ur, Ur, Qlf
Ur, Uhe, Uue, Uue, Ss, Ss, Uue, Uue, Uue, Uue, Uue, Ur, Ss, Ss, Ss, Xue, Ss, Ss, Ss, Ss, Xue, Xue, Xue, Sm, Sm, Ss, Ss, Ss, Xue, Qlf, Qlf, Ur
Xue, Xue, Xue, Uue, Uue, Ss, Ss, Ss, Ss, Ss, Ur, Ur, Ss, Ss, Ss, Ss, Ss, Ss, Ss, Ss, Xue, Ss, Ss, Ss, Ss, Ss, Ss, Ss, Ss, Xue, Qlf, Qlf
Xue, Xue, Xue, Uue, Uue, Uhe, Ss, Ss, Ss, Ss, Ss^Bw|, Ss, Ss, Ss, Xue, Ss, Ss, Ss, Ss, Ss, Ss, Ss, Xue, Xue, Xue, Xue, Ss, Ss, Ss, Xue, Xue, Qlf
Xue, Xue, Xue, Xue, Xue, Xue, Xue, Ss, Ss, Ss, Ss, Ss, Ss, Xue, Xue, Ss, Ss, Ss, Ss, Ss, Ss, Xue, Xue, Xue, Xue, Xue, Xue, Xue, Xue, Xue, Xue, Xue
